# *DO NOT DIRECTLY EDIT THIS FILE, IT IS AUTOMATICALLY GENERATED AND IT IS BASED ON:*
# https://docs.google.com/spreadsheet/ccc?key=0AmQEO36liL4FdDJLWVNMaVV2UmRKSnpXU09MYkdGbEE
aboutDrawio=draw.io 정보
accessDenied=접근거부
action=Action
actualSize=실제 크기
add=추가
addedFile=추가된 {1}
addImages=이미지 추가
addImageUrl=이미지 URL 추가
addLayer=레이어 추가
addProperty=속성 추가
address=주소
addToExistingDrawing=기존 그림에 추가
addWaypoint=중간점 추가
adjustTo=맞춤
advanced=고급
align=정렬
alignment=정렬
allChangesLost=모든 변경내용이 손실됩니다!
allPages=모든 페이지
allProjects=모든 프로젝트
allSpaces=전체
allTags=모든 태그
anchor=고정
android=안드로이드
angle=각도
arc=Arc
areYouSure=계속 진행하시겠습니까?
ensureDataSaved=종료하기 전에 데이터를 모두 저장하십시오.
allChangesSaved=모든 변경내용 저장 완료
allChangesSavedInDrive=모든 변경내용 드라이브에 저장 완료
allowPopups=이 대화상자를 보지 않으려면 팝업을 허용하십시오.
allowRelativeUrl=Allow relative URL
alreadyConnected=노드가 이미 연결됨
apply=적용
archiMate21=ArchiMate 2.1
arrange=배열
arrow=화살표
arrows=화살표
asNew=새로
atlas=모던
author=저자
authorizationRequired=승인이 필요합니다
authorizeThisAppIn={1}에서 본 프로그램 승인:
authorize=승인
authorizing=승인중
automatic=자동
autosave=자동 저장
autosize=자동 크기
attachments=첨부파일
aws=AWS
aws3d=AWS 3D
azure=하늘색
background=배경
backgroundColor=배경색
backgroundImage=배경 이미지
basic=기본
blankDrawing=공백 그림
blankDiagram=공백 다이어그램
block=블록
blockquote=인용문
blog=블로그
bold=굵게
bootstrap=부트스트랩
border=Border
borderColor=테두리 색
borderWidth=테두리 너비
bottom=아래쪽
bottomAlign=아래로  정렬
bottomLeft=왼쪽 하단
bottomRight=오른쪽 하단
bpmn=BPMN
browser=브라우저
bulletedList=글머리 기호
business=비즈니스
busy=작업이 진행 중입니다.
cabinets=캐비넷
cancel=취소
center=가운데
cannotLoad=불러오기에 실패하였습니다. 나중에 다시 시도하십시오.
cannotLogin=로그인에 실패하였습니다. 나중에 다시 시도하십시오.
cannotOpenFile=파일을 열 수 없습니다
change=변경
changeOrientation=방향 변경
changeUser=사용자 변경
changesNotSaved=변경내용이 저장되지 않았습니다
chatJoined={1}님이 대화에 참여했습니다
chatLeft={1}님이 대화에서 나갔습니다
chatWindowTitle=대화창
chooseAnOption=옵션 선택
chromeApp=크롬 앱
compressed=압축
commitMessage=메세지 전송
csv=CSV
dark=Dark
draftFound={1}'의 임시저장이 확인되었습니다. 편집하시려면 불러오기를 클릭하시고, 계속하시려면 취소를 클릭해 주시기 바랍니다.
dragAndDropNotSupported=이미지 드래그하여 붙여넣기는 지원되지 않습니다. 이미지를 불러오시겠습니까?
dropboxCharsNotAllowed=다음 문자는 사용할 수 없습니다. \ / : ? * " |
check=확인
circle=원형
cisco=시스코
classic=기본적인
clearDefaultStyle=기본 스타일 제거
clearWaypoints=중간점 제거
clipart=클립아트
close=닫기
collaborator=공동작업자
collaborators=공동작업자
collapse=접기
collapseExpand=접기/펼치기
collapse-expand=인접한 객체 이동하시려면 접기/펼치기\nShift를 클릭하여 주시기 바랍니다. 그룹 크기 유지하시려면 \nAlt를 클릭해 주시기 바랍니다. 
collapsible=접기가능
comic=코믹
comment=의견
commentsNotes=의견/메모
compress=Compress
connect=연결
connecting=연결중
connectWithDrive=구글 드라이브에 연결
connection=연결
connectionArrows=연결 화살표
connectionPoints=연결점
constrainProportions=비율 고정
containsValidationErrors=인증 오류 포함
copiedToClipboard=클립보드에 복사됨
copy=복사
copyConnect=연결 시 복사
copyOf={1}의 복사본
copyOfDrawing=그림 복사본
copySize=Copy Size
copyStyle=스타일 복사
create=만들기
createNewDiagram=새로운 다이어그램 만들기
createRevision=수정본 만들기
createShape=도형 만들기
crop=자르기
curved=곡선
custom=사용자 정의
current=현재
cut=잘라내기
dashed=대시
decideLater=나중에 결정
default=기본
delete=삭제
deleteColumn=열 삭제
deleteLibrary401=해당 라이브러리를 제거하기 위한 권한이 불충분합니다.
deleteLibrary404=선택된 라이브러리가 발견되지 않습니다,
deleteLibrary500=라이브러리를 삭제하는 동안 오류가 발생하였습니다.
deleteLibraryConfirm=해당 라이브러리가 영구적으로 제거됩니다. 계속하시겠습니까?
deleteRow=행 삭제
description=설명
device=사용자 기기
diagram=다이어그램
diagramContent=다이어그램 내용
diagramLocked=추가 데이터 손실을 막기 위해 다이어그램이 잠겼습니다.
diagramLockedBySince=The diagram is locked by {1} since {2} ago
diagramName=다이어그램 이름
diagramIsPublic=다이어그램은 공개상태입니다.
diagramIsNotPublic=다이어그램이 공개되지 않습니다.
diamond=다이아몬드
diamondThin=다이아몬드(얇은)
didYouKnow=알고계셨나요…
direction=방향   
discard=취소
discardChangesAndReconnect=변경내용 취소 후 다시 연결
googleDriveMissingClickHere=구글 드라이브가 없습니까?
discardChanges=변경내용 취소
disconnected=연결 끊김
distribute=분배
done=완료
dotted=점선
doubleClickOrientation=더블 클릭하여 방향 변경
doubleClickTooltip=더블 클릭하여 텍스트 삽입
doubleClickChangeProperty=더블 클릭하여 속성명 변경
download=다운로드
downloadDesktop=Download draw.io Desktop
downloadAs=다른 파일 형식으로 다운로드
clickHereToSave=저장하시려면 여기를 클릭해 주시기 바랍니다.
draftDiscarded=임시저장 삭제
draftSaved=임시저장
dragElementsHere=요소들을 여기로 드래그해 주시기 바랍니다.
dragImagesHere=이미지 또는 URL을 여기로 드래그해 주시기 바랍니다.
dragUrlsHere=URL을 여기로 드래그해 주시기 바랍니다.
draw.io=draw.io
drawing=그림{1}
drawingEmpty=그림이 비어있음
drawingTooLarge=그림 크기가 너무 큽니다
drawioForWork=GSuite를 위한 Draw.io
dropbox=드롭박스
duplicate=복제
duplicateIt={1} 복제
divider=분할
dx=Dx
dy=Dy
east=우측
edit=편집
editData=데이터 편집
editDiagram=다이어그램 편집
editGeometry=도형 구조 편집
editImage=이미지 편집
editImageUrl=이미지 URL 편집
editLink=링크 편집
editShape=도형 편집
editStyle=스타일 편집
editText=텍스트 편집
editTooltip=말풍선 편집
glass=유리 효과
googleImages=구글 이미지
imageSearch=이미지 검색
eip=EIP
embed=끼워넣기
embedImages=이미지 끼워넣기
mainEmbedNotice=아래 내용을 해당 페이지에 붙여넣기 하십시오
electrical=전기적
ellipse=Ellipse
embedNotice=아래 내용을 페이지 하단에 한번만 붙여넣기 하십시오
enterGroup=그룹 입력
enterName=이름 입력
enterPropertyName=속성 이름 입력
enterValue=값 입력
entityRelation=객체 관계
error=오류 
errorDeletingFile=파일 삭제 오류
errorLoadingFile=파일 불러오기 오류
errorRenamingFile=파일 이름바꾸기 오류
errorRenamingFileNotFound=파일 이름바꾸기 오류. 파일을 찾을 수 없습니다.
errorRenamingFileForbidden=파일 이름바꾸기 오류. 접근 권한이 부족합니다.
errorSavingDraft=임시저장 오류
errorSavingFile=파일 저장 오류
errorSavingFileUnknown=구글 서버 승인 오류. 페이지 새로 고침 후 다시 시도하십시오.
errorSavingFileForbidden=파일 저장 오류. 접근 권한이 부족합니다.
errorSavingFileNameConflict=다이어그램이 저장되지 못하였습니다. 이미 '{1}' 이름을 가진 파일이 해당 페이지에 존재합니다.
errorSavingFileNotFound=파일 저장 오류. 파일을 찾을 수 없습니다.
errorSavingFileReadOnlyMode=Could not save diagram while read-only mode is active.
errorSavingFileSessionTimeout=세션이 종료 되었습니다. <a target='_blank' href='{1}'>{2}</a> 해주시고, 다시 저장하시려면 해당 탭으로 돌아가 주시기 바랍니다.
errorSendingFeedback=의견 보내기 오류
errorUpdatingPreview=업데이트 미리보기 오류
exit=나가기
exitGroup=그룹 나가기
expand=펼치기
export=내보내기
exporting=내보내는 중
exportAs=다른 파일 형식으로 내보내기
exportOptionsDisabled=내보내기 옵션 사용불가
exportOptionsDisabledDetails=소유자가 확인자 및 주석자들의 다운로드, 인쇄, 복사를 허용하지 않습니다.
extras=추가 도구
facebook=페이스북
failedToSaveTryReconnect=저장 실패, 재연결중
featureRequest=기능 요청
feedback=의견
feedbackSent=의견 보내기 성공.
floorplans=평면도
file=파일
fileChangedOverwrite=파일이 변경되었습니다. 변경을 덮어쓰기 하시겠습니까?
overwrite=덮어쓰기
filename=파일 이름
fileExists=파일이 이미 존재합니다
fileNearlyFullSeeFaq=파일에 빈 공간이 거의 남아있지 않습니다. FAQ를 확인해 주시기 바랍니다.
fileNotFound=파일을 찾을 수 없습니다
repositoryNotFound=저장소를 찾을 수 없습니다
fileNotFoundOrDenied=파일을 찾지 못했습니다. 파일이 존재하지 않거나 읽기 권한이 없습니다.
fileNotLoaded=파일 불러오기 실패
fileNotSaved=파일 저장 실패
fileOpenLocation=파일을 어디에서 여시겠습니까?
fileWillBeSavedInAppFolder={1} 파일이 프로그램 폴더에 저장됩니다.
fill=채우기
fillColor=채우기 색 
filterCards=Filter Cards
find=찾기
fit=맞추기
fitContainer=도형 크기 조정
fitIntoContainer=도형 안에 맞추기
fitPage=페이지에 맞추기
fitPageWidth=페이지 너비에 맞추기
fitTo=맞추기
fitToSheetsAcross=시트 가로정렬
fitToBy=옆에
fitToSheetsDown=시트 아래정렬
fitTwoPages=두 페이지
fitWindow=창 크기에 맞추기
flip=뒤집기
flipH=가로로 뒤집기
flipV=세로로 뒤집기
flowchart=순서도
folder=폴더
font=글꼴
fontColor=글꼴 색
fontFamily=글꼴 집합
fontSize=글꼴 크기
forbidden=이 파일에 대한 접근 권한이 없습니다.
format=서식
formatPanel=서식 창
formatted=서식 적용됨
formattedText=서식 적용된 텍스트
formatPng=PNG
formatGif=GIF
formatJpg=JPEG
formatPdf=PDF
formatSql=SQL
formatSvg=SVG
formatHtmlEmbedded=HTML
formatSvgEmbedded=SVG (XML 포함)
formatVsdx=VSDX
formatVssx=VSSX
formatXmlPlain=XML (일반)
formatXml=XML
forum=논의/문의장
fromTemplate=템플릿에서
fromTemplateUrl=템플릿 URL에서
fromText=텍스트에서
fromUrl=URL로부터
fromThisPage=해당 페이지로부터
fullscreen=전체화면
gap=Gap
gcp=GCP
general=일반
github=GitHub
gliffy=Gliffy
global=전체
googleDocs=구글 문서
googleDrive=구글 드라이브
googleGadget=구글 가젯
googlePlus=구글 플러스
googleSites=구글 사이트
gradient=그라데이션
gradientColor=색
grid=격자
gridColor=격자 색상
gridSize=격자 크기
group=그룹
guides=안내
hateApp=난 draw.io가 싫어요
heading=제목
height=높이
help=도움말
helpTranslate=본 프로그램의 번역을 도와주세요
hide=숨기기
hideIt={1} 숨기기
hidden=숨김
home=처음으로
horizontal=수평
horizontalFlow=수평 흐름도
horizontalTree=수평 트리 그림
howTranslate=귀하의 언어로 번역된 내용들이 얼마나 이해하기 쉽습니까?
html=HTML
htmlText=HTML 텍스트
id=ID
iframe=IFrame
ignore=무시
image=이미지
imageUrl=이미지 URL
images=이미지
imagePreviewError=이미지가 로딩되지 않아 미리보기가 지원되지 않습니다. URL을 확인해 주시기 바랍니다.
imageTooBig=이미지 크기가 너무 큽니다
imgur=Imgur
import=가져오기
importFrom=가져오기 위치
includeCopyOfMyDiagram=내 다이어그램 복사본 포함하기
increaseIndent=들여쓰기
decreaseIndent=내어쓰기
insert=삽입
insertColumnBefore=왼쪽에 행 삽입
insertColumnAfter=오른쪽에 행 삽입
insertEllipse=원형 삽입
insertImage=이미지 삽입
insertHorizontalRule=가로선 삽입
insertLink=링크 삽입
insertPage=Insert Page
insertRectangle=직사각형 삽입
insertRhombus=Insert Rhombus
insertRowBefore=위에 열 삽입
insertRowAfter=아래에 열 삽입
insertText=텍스트 삽입
inserting=삽입중
invalidFilename=다이어그램 이름에 다음 문자들은 사용될 수 없습니다. \ / | : ; { } < > & + ? = "
invalidLicenseSeeThisPage=라이선스가 유효하지 않습니다. <a target="_blank" href="https://support.draw.io/display/DFCS/Licensing+your+draw.io+plugin">페이지</a>를 확인해 주시기 바랍니다.
invalidName=유효하지 않은 이름
invalidOrMissingFile=유효하지 않거나 분실된 파일
invalidPublicUrl=유효하지 않은 공개 URL
isometric=동일
ios=iOS
italic=기울임꼴
kennedy=케네디
keyboardShortcuts=키보드 단축키
layers=레이어
landscape=가로
language=언어
leanMapping=린 매핑
lastChange={1} 전 마지막으로 변경됨
lessThanAMinute=방금
licensingError=라이선스 오류
licenseHasExpired={1} 관련 라이선스가 {2}에 만료되었습니다. 여기를 클릭해 주시기 바랍니다.
licenseWillExpire={1} 관련 라이선스가 {2}에 만료될 예정입니다. 여기를 클릭해 주시기 바랍니다.
lineJumps=Line jumps
linkAccountRequired=다이어그램이 공개상태가 아닌 경우, 링크를 확인하기 위해 구글 계정이 필요합니다.
linkText=링크 텍스트
list=목록
minute=분
minutes=분
hours=시간
days=일
months=개월
years=년
restartForChangeRequired=페이지 새로 고침 후 변경내용이 적용됩니다.
laneColor=레인 색
lastModified=최근 변경 사항
layout=레이아웃
left=왼쪽
leftAlign=왼쪽 정렬
leftToRight=좌에서 우로
libraryTooltip=삽입하시려면 여기에 도형을 드래그하여 붙여넣기 하시거나 +를 클릭해 주시기 바랍니다. 편집하시려면 더블 클릭해 주시기 바랍니다.
lightbox=라이트박스
line=선
lineend=선 끝
lineheight=선 높이
linestart=선 시작
linewidth=선 너비
link=링크
links=링크
loading=불러오는중
lockUnlock=잠금/잠금 해제
loggedOut=로그아웃
logIn=로그인
loveIt=난 {1}가 좋아요
lucidchart=Lucidchart
maps=Maps
mathematicalTypesetting=수학 공식 입력
makeCopy=복사본 만들기
manual=수동
middle=중간
minimal=Minimal
misc=기타
mockups=모형
modificationDate=변경일
modifiedBy=변경됨
more=그 외
moreResults=그 외 결과
moreShapes=그 외 도형
move=이동
moveToFolder=폴더로 이동
moving=이동중
moveSelectionTo={1}(으)로 선택 이동
name=이름
navigation=탐색
network=Network
networking=네트워킹
new=새로 만들기
newLibrary=새로운 라이브러리
nextPage=다음 페이지
no=아니
noAttachments=첨부파일 없음
noColor=색 없음
noFiles=파일 없음
noFileSelected=선택된 파일 없음
noLibraries=라이브러리 없음
noMoreResults=더 이상 표시 결과 없음
none=없음
noOtherViewers=기타 확인하고 있는 사용자 없음
noPlugins=플러그인 없음
noPreview=미리보기 없음
noResponse=서버로부터 응답 없음
noResultsFor={1}'에 대한 결과 없음
noRevisions=수정내용 없음
noSearchResults=검색결과 없음
noPageContentOrNotSaved=본 페이지에 고정값이나 저장된 값이 없습니다.
normal=정상
north=상
notADiagramFile=다이어그램 파일이 아닙니다
notALibraryFile=라이브러리 파일이 아닙니다
notAvailable=이용 불가
notAUtf8File=UTF-8 파일이 아닙니다
notConnected=연결되지 않음
note=메모
notUsingService={1} 서비스를 사용하지 않고 계십니까?
numberedList=글머리 번호
offline=오프라인
ok=확인
oneDrive=원드라이브
online=온라인
opacity=불투명
open=열기
openArrow=열린 화살표
openExistingDiagram=기존 다이어그램 열기
openFile=파일 열기
openFrom=파일 열기 위치
openLibrary=라이브러리 열기
openLibraryFrom=라이브러리 열기 위치
openLink=링크 열기
openInNewWindow=새 창에서 열기
openInThisWindow=현재 창에서 열기
openIt={1} 열기
openRecent=최근 파일 열기
openSupported=본 프로그램은 저장 파일 (.xml) 및 .vsdx, .gliffy 파일 형식을 지원합니다.
options=옵션
organic=유기적 객체
orthogonal=직각
otherViewer=다른 뷰어
otherViewers=다른 뷰어
outline=윤곽
oval=타원형
page=페이지
pageContent=페이지 내용
pageNotFound=페이지가 발견되지 않습니다
pageWithNumber=페이지-{1}
pages=페이지
pageView=페이지 보기
pageSetup=페이지 설정
pageScale=페이지 크기
pan=화면 이동
panTooltip=스페이스키 + 드래그하여 화면 이동
paperSize=용지 크기
pattern=패턴
paste=붙여넣기
pasteHere=여기에 붙여넣기
pasteSize=Paste Size
pasteStyle=스타일 붙여넣기
perimeter=둘레
permissionAnyone=누구든 편집할 수 있습니다
permissionAuthor=오직 저만 편집할 수 있습니다
pickFolder=폴더 선택
pickLibraryDialogTitle=라이브러리 선택
publicDiagramUrl=다이어그램의 공개 URL
placeholders=플레이스홀더
plantUml=PlantUML
plugins=플러그인
pluginUrl=플러그인 URL
pluginWarning=이 페이지에서 다음의 플러그인 불러오기를 요청했습니다:\n \n {1}\n \n 지금 플러그인을 불러오시겠습니까?\n \n 주의 : 보안상 실행이 안전하다고 판단되는 플러그인만 허용하시기 바랍니다.\n
plusTooltip=연결 및 복제하시려면 클릭해 주시기 바랍니다 (복제하시려면 ctrl+클릭, 연결하시려면 shift+클릭). 연결하시려면 드래그해 주시기 바랍니다 (복제하시려면 ctrl+드래그).
portrait=세로
position=위치
posterPrint=포스터 인쇄
preferences=환경 설정
preview=미리보기
previousPage=이전 페이지
print=인쇄
printAllPages=전체 인쇄
procEng=공정 공학
project=프로젝트
priority=우선순위
properties=속성
publish=게재
quickStart=빠른 시작 비디오
rack=랙
radialTree=방사형 트리
readOnly=읽기 전용
reconnecting=다시 연결중
recentlyUpdated=최근 업데이트
recentlyViewed=최근 확인
rectangle=Rectangle
redirectToNewApp=해당 파일은 본 프로그램의 새로운 버전으로 생성 또는 수정되었습니다. 지금 페이지를 이동합니다.
realtimeTimeout=일부 변경내용이 오프라인 상태에서 입력되었습니다. 해당 변경내용을 저장할 수 없습니다.
redo=다시 실행
refresh=새로 고침
regularExpression=일반 표현
relative=Relative
relativeUrlNotAllowed=Relative URL not allowed
rememberMe=로그인 기억하기
rememberThisSetting=이 설정 기억하기
removeFormat=서식 제거
removeFromGroup=그룹에서 제거
removeIt={1} 제거
removeWaypoint=중간점 제거
rename=이름 바꾸기
renamed=이름 변경됨
renameIt={1} 이름 바꾸기
renaming=이름 변경중
replace=교체
replaceIt={1}가 이미 존재합니다. 교체하시겠습니까?
replaceExistingDrawing=기존 그림 교체
required=필요
reset=재설정
resetView=뷰어 재설정
resize=크기 조정
resizeLargeImages=Do you want to resize large images to make the application run faster?
retina=망막
responsive=응답
restore=복구
restoring=복구중
retryingIn={1)초 후 재시도 예정
retryingLoad=불러오기 실패. 재시도중…
retryingLogin=로그인 시간 초과. 재시도중…
reverse=반전
revision=수정
revisionHistory=수정 내역
rhombus=Rhombus
right=오른쪽
rightAlign=오른쪽 정렬
rightToLeft=우에서 좌로
rotate=회전
rotateTooltip=클릭 후 드래그하여 회전, 클릭하여 90도 회전
rotation=회전
rounded=둥근선
save=저장
saveAndExit=저장 후 나가기
saveAs=다른 이름으로 저장
saveAsXmlFile=XML 파일로 저장하시겠습니까?
saved=저장됨
saveDiagramsTo=다이어그램 저장
saveLibrary403=본 라이브러리의 편집 권한 부족
saveLibrary500=라이브러리 저장 중 오류가 발생하였습니다.
saving=저장중
scratchpad=스크래치패드
scrollbars=스크롤바
search=검색
searchShapes=도형 검색
selectAll=모두 선택
selectionOnly=검색 값만
selectCard=Select Card
selectEdges=테두리 선택
selectFile=파일 선택
selectFolder=폴더 선택
selectFont=글꼴 선택
selectNone=선택 값 없음
selectTemplate=Select Template
selectVertices=꼭짓점 선택
sendMessage=보내기
sendYourFeedbackToDrawIo=draw.io로 사용자 의견 보내기
serviceUnavailableOrBlocked=서비스 이용 불가 혹은 서비스 차단
sessionExpired=세션이 종료되었습니다. 브라우저 윈도우 창을 새로 고침 하십시오.
sessionTimeoutOnSave=세션이 시간 초과되어 구글 드라이브 연결이 해제되었습니다. 로그인 후 저장하려면 확인을 누르십시오.
setAsDefaultStyle=기본 스타일로 설정
shadow=음영
shape=도형
shapes=도형
share=공유
shareLink=편집 공유 링크
sharp=곧은선
show=보이기
showStartScreen=시작 화면 보기
sidebarTooltip=확장하시려면 클릭해 주시기 바랍니다. 다이어그램에 도형을 드래그해서 붙여넣기 해주시기 바랍니다. 선택 사항을 변경하시려면 Shift+클릭을 눌러 주시기 바랍니다. 삽입 및 연결하시려면 Alt+클릭을 눌러주시기 바랍니다.
signs=표시 사인
signOut=로그아웃
simple=단순
simpleArrow=단순 화살표
size=크기
solid=실선
sourceSpacing=소스 간격
south=하단
software=소프트웨어
space=간격
spacing=간격
specialLink=특수 링크
standard=기본
starting=시작하는중
straight=직선
strokeColor=선 색
style=스타일
subscript=아래 첨자
summary=요약
superscript=위 첨자
support=고객지원
sysml=SysML
tags=태그
table=표
tables=Tables
takeOver=Take Over
targetSpacing=객체 간격
template=탬플릿
templates=탬플릿
text=텍스트
textAlignment=텍스트 정렬
textOpacity=텍스트 불투명도
theme=테마
timeout=시간 초과
title=제목
to=로
toBack=뒤로
toFront=앞으로
tooltips=말풍선
top=위쪽
topAlign=위로 정렬
topLeft=왼쪽 상단
topRight=오른쪽 상단
transparent=투명
transparentBackground=투명한 배경
trello=Trello
tryAgain=다시 시도하십시오
tryOpeningViaThisPage=본 페이지를 통해 열어 주시기 바랍니다.
turn=90도 회전
type=유형
twitter=트위터
uml=UML
underline=밑줄
undo=실행 취소
ungroup=그룹 해제
unsavedChanges=저장되지 않은 변경내용
unsavedChangesClickHereToSave=저장되지 않은 변경내용이 있습니다. 저장하시려면 여기를 클릭해 주시기 바랍니다.
untitled=제목없음
untitledDiagram=제목 없는 다이어그램
untitledLayer=제목 없는 단계층
untitledLibrary=제목 없는 라이브러리
unknownError=알 수 없는 오류
updateFile={1} 업데이트
updatingDocument=문서 업데이트 중. 잠시만 기다려주십시오…
updatingPreview=미리보기 업데이트 중. 잠시만 기다려주십시오…
updatingSelection=선택내용 업데이트중. 잠시 기다려주십시오…
upload=업로드
url=URL
useOffline=Use Offline
useRootFolder=Use root folder?
userManual=사용자 매뉴얼
vertical=수직
verticalFlow=수직 흐름도
verticalTree=수직 트리 그림
view=보기
viewUrl=확인 링크: {1}
voiceAssistant=음성 지원 (베타 서비스)
warning=경고
waypoints=중간점
west=좌측
width=너비
wiki=위키
wordWrap=텍스트 줄 바꿈
writingDirection=텍스트 방향
yes=예
yourEmailAddress=사용자 이메일 주소
zoom=확대
zoomIn=확대
zoomOut=축소 
basic=기본
businessprocess=업무 프로세스
charts=차트
engineering=엔지니어링
flowcharts=순서도
gmdl=재료 설계
mindmaps=마인드맵
mockups=모형
networkdiagrams=네트워크 다이어그램
nothingIsSelected=아무것도 선택되지 않았습니다
other=기타
softwaredesign=소프트웨어 설계
venndiagrams=벤 다이어그램
webEmailOrOther=홈페이지, 이메일 혹은 기타 인터넷 주소
webLink=홈페이지 링크
wireframes=와이어 프레임
