# *DO NOT DIRECTLY EDIT THIS FILE, IT IS AUTOMATICALLY GENERATED AND IT IS BASED ON:*
# https://docs.google.com/spreadsheet/ccc?key=0AmQEO36liL4FdDJLWVNMaVV2UmRKSnpXU09MYkdGbEE
aboutDrawio=Tentang draw.io
accessDenied=Akses Ditolak
action=Action
actualSize=Ukuran Aktual
add=Tambahkan
addedFile=Ditambahkan
addImages=Tambahkan Gambar
addImageUrl=Tambahkan URL Gambar
addLayer=Tambahkan Lapisan
addProperty=Tambahkan Properti
address=Alamat
addToExistingDrawing=Tambahkan ke Gambar yang Ada
addWaypoint=Tambahkan Waypoint
adjustTo=Atur ke
advanced=Lanjutan
align=Ratakan
alignment=Perataan
allChangesLost=Semua perubahan akan hilang!
allPages=Semua Halaman
allProjects=Semua Proyek
allSpaces=Semua Ruang
allTags=Semua Tag
anchor=Jangkar
android=Android
angle=Sudut
arc=Arc
areYouSure=Anda yakin?
ensureDataSaved=Pastikan data tersimpan sebelum menutup.
allChangesSaved=Semua data tersimpan
allChangesSavedInDrive=Semua data tersimpan di Drive
allowPopups=Izinkan pop-up untuk menghindari dialog ini.
allowRelativeUrl=Allow relative URL
alreadyConnected=Node telah terhubung
apply=Terapkan
archiMate21=ArchiMate 2.1
arrange=Susun
arrow=Panah
arrows=Panah
asNew=Baru
atlas=Atlas
author=Pemilik
authorizationRequired=Perlu otorisasi
authorizeThisAppIn=Otorisasikan apl ini dalam {1}:
authorize=Otorisasikan
authorizing=Memberikan otorisasi
automatic=Otomatis
autosave=Simpan otomatis
autosize=Ukur otomatis
attachments=Lampiran
aws=AWS
aws3d=AWS 3D
azure=Azure
background=Latar
backgroundColor=Warna Latar
backgroundImage=Gambar Latar
basic=Dasar
blankDrawing=Gambar Kosong
blankDiagram=Diagram Kosong
block=Blok
blockquote=Blockquote
blog=Blog
bold=Tebal
bootstrap=Bootstrap
border=Border
borderColor=Warna Tepi
borderWidth=Lebar Tepi
bottom=Bawah
bottomAlign=Rata Bawah
bottomLeft=Kiri Bawah
bottomRight=Kanan Bawah
bpmn=BPMN
browser=Peramban
bulletedList=Daftar Bullet
business=Bisnis
busy=Operasi sedang berjalan
cabinets=Kabinet
cancel=Batalkan
center=Tengah
cannotLoad=Upaya muat gagal. Harap coba lagi nanti.
cannotLogin=Upaya login gagal. Harap coba lagi nanti.
cannotOpenFile=Tidak dapat membuka berkas
change=Ubah
changeOrientation=Ubah Orientasi
changeUser=Ubah pengguna
changesNotSaved=Perubahan belum tersimpan
chatJoined={1} bergabung
chatLeft={1} keluar
chatWindowTitle=Obrolan
chooseAnOption=Pilih salah satu opsi
chromeApp=Aplikasi Chrome
compressed=Mampat
commitMessage=Kirim Pesan
csv=CSV
dark=Dark
draftFound=Draf untuk '{1}' ditemukan. Muat ke editor atau buang untuk melanjutkan.
dragAndDropNotSupported=Tidak mendukung seret dan jatuhkan untuk gambar. Anda ingin mengimpor?
dropboxCharsNotAllowed=Karakter berikut tidak diizinkan: \ / : ? * " |
check=Cek
circle=Lingkaran
cisco=Cisco
classic=Klasik
clearDefaultStyle=Hapus Gaya Default
clearWaypoints=Hapus Waypoint
clipart=Clipart
close=Tutup
collaborator=Kolaborator
collaborators=Kolaborator
collapse=Persempit
collapseExpand=Perluas/Persempit
collapse-expand=Klik untuk mempersempit/memperluas\nShift-klik untuk memindahkan \nAlt-klik untuk melindungi ukuran grup
collapsible=Dapat dipersempit
comic=Komik
comment=Komentar
commentsNotes=Komentar/Catatan
compress=Compress
connect=Hubungkan
connecting=Menghubungkan
connectWithDrive=Hubungkan dengan Google Drive
connection=Koneksi
connectionArrows=Panah Koneksi
connectionPoints=Poin Koneksi
constrainProportions=Batasi Proporsi
containsValidationErrors=Mengandung galat validasi
copiedToClipboard=Disalin ke papan klip
copy=Salin
copyConnect=Salin saat terhubung
copyOf=Salinan {1}
copyOfDrawing=Salinan Gambar
copySize=Copy Size
copyStyle=Salin Gaya
create=Buat
createNewDiagram=Buat Diagram Baru
createRevision=Buat Revisi
createShape=Buat Bentuk
crop=Potong
curved=Melengkung
custom=Kustom
current=Saat Ini
cut=Crop
dashed=Garis-garis
decideLater=Putuskan nanti
default=Default
delete=Hapus
deleteColumn=Hapus Kolom
deleteLibrary401=Tidak cukup izin untuk menghapus pustaka ini
deleteLibrary404=Pustaka terpilih tidak dapat ditemukan
deleteLibrary500=Galat menghapus pustaka
deleteLibraryConfirm=Anda akan menghapus pustaka ini secara permanen. Anda yakin ingin melakukannya?
deleteRow=Hapus Baris
description=Deskripsi
device=Peranti
diagram=Diagram
diagramContent=Konten Diagram
diagramLocked=Diagram dikunci untuk mencegah data hilang lebih banyak.
diagramLockedBySince=The diagram is locked by {1} since {2} ago
diagramName=Nama Diagram
diagramIsPublic=Diagram publik
diagramIsNotPublic=Diagram tidak publik
diamond=Permata
diamondThin=Permata (tipis)
didYouKnow=Tahukah Anda...
direction=Arah
discard=Buang
discardChangesAndReconnect=Buang Perubahan dan Hubungkan Ulang
googleDriveMissingClickHere=Google Drive hilang? Klik di sini!
discardChanges=Buang Perubahan
disconnected=Terputus
distribute=Distribusikan
done=Selesai
dotted=Titik-titik
doubleClickOrientation=Klik dua kali untuk mengubah orientasi
doubleClickTooltip=Klik dua kali untuk menyisipkan teks
doubleClickChangeProperty=Klik dua kali untuk mengubah nama properti
download=Unduh
downloadDesktop=Download draw.io Desktop
downloadAs=Unduh sebagai
clickHereToSave=Klik di sini untuk menyimpan.
draftDiscarded=Draf dibuang
draftSaved=Draf disimpan
dragElementsHere=Seret elemen ke arah ini
dragImagesHere=Seret gambar atau URL ke arah ini
dragUrlsHere=Seret URL ke arah ini
draw.io=draw.io
drawing=Gambar{1}
drawingEmpty=Gambar kosong
drawingTooLarge=Gambar terlalu besar
drawioForWork=Draw.io untuk GSuite
dropbox=Dropbox
duplicate=Duplikasikan
duplicateIt=Duplikasikan {1}
divider=Pemisah
dx=Dx
dy=Dy
east=Timur
edit=Edit
editData=Edit Data
editDiagram=Edit Diagram
editGeometry=Edit Geometri
editImage=Edit Gambar
editImageUrl=Edit URL Gambar
editLink=Edit Tautan
editShape=Edit Bentuk
editStyle=Edit Gaya
editText=Edit Teks
editTooltip=Edit Tooltip
glass=Kaca
googleImages=Gambar Google
imageSearch=Pencarian Gambar
eip=EIP
embed=Tanamkan
embedImages=Tanamkan Gambar
mainEmbedNotice=Tempelkan pada halaman ini
electrical=Elektrik
ellipse=Ellipse
embedNotice=Tampelkan satu kali di akhir halaman
enterGroup=Masuk Grup
enterName=Masukkan Nama
enterPropertyName=Masukkan Nama Properti
enterValue=Masukkan Nilai
entityRelation=Relasi Entitas
error=Galat
errorDeletingFile=Galat Menghapus Berkas
errorLoadingFile=Galat memuat berkas
errorRenamingFile=Galat menamai ulang berkas.
errorRenamingFileNotFound=Galat menamai ulang berkas. Berkas tidak dapat ditemukan.
errorRenamingFileForbidden=Galat menamai ulang berkas. Hak akses tidak cukup.
errorSavingDraft=Galat menyimpan draf
errorSavingFile=Galat menyimpan berkas
errorSavingFileUnknown=Galat otorisasi dengan peladen Google. Harap segarkan halaman untuk mencoba lagi.
errorSavingFileForbidden=Galat menyimpan berkas. Hak akses tidak cukup.
errorSavingFileNameConflict=Tidak dapat menyimpan diagram. Halaman saat ini telah berisi berkas dengan nama '{1}'.
errorSavingFileNotFound=Galat menyimpan berkas. Berkas tidak ditemukan.
errorSavingFileReadOnlyMode=Could not save diagram while read-only mode is active.
errorSavingFileSessionTimeout=Sesi Anda telah berakhir. Harap <a target='_blank' href='{1}'>{2}</a> dan kembali ke tab ini untuk mencoba menyimpan sekali lagi.
errorSendingFeedback=Galat mengirim umpan balik.
errorUpdatingPreview=Galat memperbarui pratinjau.
exit=Keluar
exitGroup=Keluar Grup
expand=Perluas
export=Ekspor
exporting=Mengekspor
exportAs=Ekspor sebagai
exportOptionsDisabled=Pilihan ekspor nonaktif
exportOptionsDisabledDetails=Pemilik telah menonaktifkan opsi unduh, cetak, atau salin untuk pengomentar dan pembaca berkas ini.
extras=Ekstra
facebook=Facebook
failedToSaveTryReconnect=Gagal menyimpan, mencoba menghubungkan kembali
featureRequest=Permintaan Fitur
feedback=Umpan Balik
feedbackSent=Umpan balik berhasil dikirim.
floorplans=Denah lantai
file=Berkas
fileChangedOverwrite=Berkas diubah. Timpa perubahan?
overwrite=Timpa
filename=Nama berkas
fileExists=Berkas telah ada
fileNearlyFullSeeFaq=Berkas hampir penuh, harap lihat FAQ
fileNotFound=Berkas tidak ditemukan
repositoryNotFound=Repositori tidak ditemukan
fileNotFoundOrDenied=Berkas tidak ditemukan. Berkas tidak ada atau Anda tidak memiliki akses baca.
fileNotLoaded=Berkas tidak termuat
fileNotSaved=Berkas tidak disimpan
fileOpenLocation=Bagaimana Anda ingin membuka berkas ini?
fileWillBeSavedInAppFolder={1} akan disimpan di folder apl.
fill=Isi
fillColor=Isi Warna
filterCards=Filter Cards
find=Cari
fit=Paskan
fitContainer=Ubah Ukuran Wadah
fitIntoContainer=Masukkan ke dalam Wadah
fitPage=Paskan Halaman
fitPageWidth=Paskan Lebar Halaman
fitTo=Paskan hingga
fitToSheetsAcross=lembar mendatar
fitToBy=dan
fitToSheetsDown=lembar menurun
fitTwoPages=Dua Halaman
fitWindow=Sesuaikan Jendela
flip=Putar
flipH=Putar Horizontal
flipV=Putar Vertikal
flowchart=Diagram Alir
folder=Folder
font=Fon
fontColor=Warna Fon
fontFamily=Famili Fon
fontSize=Ukuran Fon
forbidden=Anda tidak berwenang untuk mengakses berkas ini
format=Format
formatPanel=Panel Format
formatted=Terformat
formattedText=Teks Terformat
formatPng=PNG
formatGif=GIF
formatJpg=JPEG
formatPdf=PDF
formatSql=SQL
formatSvg=SVG
formatHtmlEmbedded=HTML
formatSvgEmbedded=SVG (dengan XML)
formatVsdx=VSDX
formatVssx=VSSX
formatXmlPlain=XML (Plain)
formatXml=XML
forum=Forum Diskusi/Bantuan
fromTemplate=Dari Templat
fromTemplateUrl=Dari URL Templat
fromText=Dari Teks
fromUrl=Dari URL
fromThisPage=Dari halaman ini
fullscreen=Layar penuh
gap=Gap
gcp=GCP
general=Umum
github=GitHub
gliffy=Gliffy
global=Global
googleDocs=Google Docs
googleDrive=Google Drive
googleGadget=Google Gadget
googlePlus=Google+
googleSites=Situs Google
gradient=Gradien
gradientColor=Warna
grid=Kisi
gridColor=Warna Kisi
gridSize=Ukuran Kisi
group=Gabungkan
guides=Panduan
hateApp=Saya tidak suka draw.io
heading=Tajuk
height=Tinggi
help=Bantuan
helpTranslate=Bantu kami menerjemahkan aplikasi ini
hide=Sembunyikan
hideIt=Sembunyikan {1}
hidden=Tersembunyi
home=Beranda
horizontal=Horizontal
horizontalFlow=Alur Horizontal
horizontalTree=Pohon Horizontal
howTranslate=Seberapa baik terjemahan ini dalam bahasa Anda?
html=HTML
htmlText=Teks HTML
id=ID
iframe=IFrame
ignore=Abaikan
image=Gambar
imageUrl=URL Gambar
images=Gambar-gambar
imagePreviewError=Gambar ini tidak dapat dimuat untuk pratinjau. Harap periksa URL.
imageTooBig=Gambar terlalu besar
imgur=Imgur
import=Impor
importFrom=Impor dari
includeCopyOfMyDiagram=Cantumkan salinan diagram saya
increaseIndent=Tambahkan Indentasi
decreaseIndent=Kurangi Indentasi
insert=Sisipkan
insertColumnBefore=Sisipkan Kolom Kiri
insertColumnAfter=Sisipkan Kolom Kanan
insertEllipse=Sisipkan Elips
insertImage=Sisipkan Gambar
insertHorizontalRule=Sisipkan Aturan Horizontal
insertLink=Sisipkan Tautan
insertPage=Sisipkan Halaman
insertRectangle=Sisipkan Persegi Panjang
insertRhombus=Insert Rhombus
insertRowBefore=Sisipkan Baris di Atas
insertRowAfter=Sisipkan Baris di Bawah
insertText=Sisipkan Teks
inserting=Menyisipkan
invalidFilename=Nama diagram tidak boleh mengandung karakter berikut: \ / | : ; { } < > & + ? = "
invalidLicenseSeeThisPage=Lisensi Anda tidak valid, harap baca tautan ini <a target="_blank" href="https://support.draw.io/display/DFCS/Licensing+your+draw.io+plugin">page</a>.
invalidName=Nama tidak valid
invalidOrMissingFile=Berkas tidak valid atau hilang
invalidPublicUrl=URL publik tidak valid
isometric=Isometrik
ios=iOS
italic=Italik
kennedy=Kennedy
keyboardShortcuts=Pintasan papan tik
layers=Lapisan
landscape=Lanskap
language=Bahasa
leanMapping=Peta Aliran Nilai
lastChange=Terakhir diubah {1} lalu
lessThanAMinute=kurang dari satu menit
licensingError=Galat Lisensi
licenseHasExpired=Lisensi {1} telah berakhir pada {2}. Klik di sini.
licenseWillExpire=Lisensi {1} akan berakhir pada {2}. Klik di sini.
lineJumps=Line jumps
linkAccountRequired=Jika diagram tidak bersifat publik, akun Google diperlukan untuk membaca tautan.
linkText=Teks Tautan
list=Daftar
minute=menit
minutes=menit
hours=jam
days=hari
months=bulan
years=tahun
restartForChangeRequired=Perubahan akan tampak setelah penyegaran halaman.
laneColor=Warna jalur
lastModified=Terakhir diubah
layout=Tata Letak
left=Kiri
leftAlign=Rata Kiri
leftToRight=Kiri ke kanan
libraryTooltip=Seret dan jatuhkan bentuk di sini atau klik + untuk menyisipkan. Klik dua kali untuk mengedit.
lightbox=Lightbox
line=Garis
lineend=Ujung garis
lineheight=Tebal Garis
linestart=Awal garis
linewidth=Lebar garis
link=Tautan
links=Tautan
loading=Memuat
lockUnlock=Mengunci/Membuka
loggedOut=Keluar
logIn=masuk
loveIt=Saya suka {1}
lucidchart=Lucidchart
maps=Maps
mathematicalTypesetting=Tata Cetak Matematis
makeCopy=Buat Salinan
manual=Manual
middle=Tengah
minimal=Minimal
misc=Lain-lain
mockups=Maket
modificationDate=Tanggal ubah
modifiedBy=Diubah oleh
more=Lainnya
moreResults=Hasil Lainnya
moreShapes=Bentuk Lainnya
move=Pindahkan
moveToFolder=Pindahkan ke Folder
moving=Pemindahan
moveSelectionTo=Pindahkan pilihan ke {1}
name=Nama
navigation=Navigasi
network=Network
networking=Jejaring
new=Baru
newLibrary=Pustaka Baru
nextPage=Halaman Berikutnya
no=Tidak
noAttachments=Tidak ada lampiran yang ditemukan
noColor=Tanpa Warna
noFiles=Tidak Ada Berkas
noFileSelected=Tidak ada berkas yang dipilih
noLibraries=Tidak ada pustaka yang ditemukan
noMoreResults=Tidak ada hasil lainnya
none=Tidak ada
noOtherViewers=Tidak ada pengunjung lain
noPlugins=Tidak ada plugin
noPreview=Tidak ada pratinjau
noResponse=TIdak ada respons dari server
noResultsFor=Tidak ada hasil untuk '{1}'
noRevisions=Tidak ada revisi
noSearchResults=Tidak ada hasil pencarian yang ditemukan
noPageContentOrNotSaved=Tidak ada jangkar yang ditemukan di halaman ini atau jangkar belum disimpan
normal=Normal
north=Utara
notADiagramFile=Bukan berkas diagram
notALibraryFile=Bukan berkas pustaka
notAvailable=Tidak tersedia
notAUtf8File=Bukan berkas UTF-8
notConnected=Tidak tersambung
note=Catatan
notUsingService=Tidak menggunakan {1}?
numberedList=Daftar urutan nomor
offline=Offline
ok=OKE
oneDrive=OneDrive
online=Online
opacity=Opasitas
open=Buka
openArrow=Buka Panah
openExistingDiagram=Buka Diagram yang Ada
openFile=Buka Berkas
openFrom=Buka dari
openLibrary=Buka Pustaka
openLibraryFrom=Buka Pustaka dari
openLink=Buka Tautan
openInNewWindow=Buka di Jendela Baru
openInThisWindow=Buka di Jendela Ini
openIt=Buka {1}
openRecent=Buka Terbaru
openSupported=Format yang didukung adalah berkas yang disimpan dari perangkat lunak ini: (.xml), .vsdx, dan .gliffy
options=Opsi
organic=Organik
orthogonal=Ortogonal
otherViewer=pengunjung lain
otherViewers=pengunjung lain
outline=Ikhtisar
oval=Oval
page=Halaman
pageContent=Isi Halaman
pageNotFound=Halaman tidak ditemukan
pageWithNumber=Halaman-{1}
pages=Halaman
pageView=Tampilan Halaman
pageSetup=Pengaturan Halaman
pageScale=Skala Halaman
pan=Perlebar
panTooltip=Spasi+Seret untuk memperlebar
paperSize=Ukuran Kertas
pattern=Pola
paste=Tempel
pasteHere=Tempel di sini
pasteSize=Paste Size
pasteStyle=Tempel Gaya
perimeter=Perimeter
permissionAnyone=Semua orang dapat mengedit
permissionAuthor=Hanya saya yang dapat mengedit
pickFolder=Pilih folder
pickLibraryDialogTitle=Pilih Pustaka
publicDiagramUrl=URL Publik diagram
placeholders=Placeholder
plantUml=PlantUML
plugins=Plugin
pluginUrl=URL Plugin
pluginWarning=Halaman ini ingin memuat plugin berikut:\n \n {1}\n \n Anda ingin memuat plugin ini sekarang?\n \n CATATAN: Hanya izinkan plugin berjalan jika Anda memahami pengaruhnya terhadap keamanan.\n
plusTooltip=Klik untuk menghubungkan dan mengklona (ctrl+klik untuk mengklona, shift+klik untuk menghubungkan). Seret untuk menghubungkan (ctrl+seret untuk mengklona).
portrait=Potret
position=Posisi
posterPrint=Cetak Poster
preferences=Preferensi
preview=Pratinjau
previousPage=Halaman Sebelumnya
print=Cetak
printAllPages=Cetak Semua Halaman
procEng=Rekayasa Proses
project=Proyek
priority=Prioritas
properties=Properti
publish=Publikasikan
quickStart=Mulai Cepat Video
rack=Rak
radialTree=Pohon Radial
readOnly=Baca saja
reconnecting=Menghubungkan ulang
recentlyUpdated=Baru Diperbarui
recentlyViewed=Baru Dilihat
rectangle=Rectangle
redirectToNewApp=Berkas dibuat atau diubah menggunakan versi terbaru apl ini. Anda akan diarahkan sekarang.
realtimeTimeout=Sepertinya Anda melakukan beberapa perubahan saat offline. Maaf, perubahan ini tidak dapat disimpan.
redo=Ulangi
refresh=Segarkan
regularExpression=Regex
relative=Relative
relativeUrlNotAllowed=Relative URL not allowed
rememberMe=Ingat saya
rememberThisSetting=Ingat pengaturan ini
removeFormat=Hapus Format
removeFromGroup=Hapus dari Grup
removeIt=Hapus {1}
removeWaypoint=Hapus Waypoint
rename=Namai Ulang
renamed=Dinamai Ulang
renameIt=Namai Ulang {1}
renaming=Menamai ulang
replace=Mengganti
replaceIt={1} telah ada. Anda ingin menggantinya?
replaceExistingDrawing=Ganti gambar yang ada
required=diperlukan
reset=Setel Ulang
resetView=Setel Ulang Tampilan
resize=Ubah Ukuran
resizeLargeImages=Do you want to resize large images to make the application run faster?
retina=Retina
responsive=Responsif
restore=Pulihkan
restoring=Memulihkan
retryingIn=Mencoba lagi dalam {1} detik
retryingLoad=Pemuatan gagal. Mencoba lagi...
retryingLogin=Waktu login habis. Mencoba lagi...
reverse=Balikkan
revision=Revisi
revisionHistory=Riwayat Revisi
rhombus=Rhombus
right=Kanan
rightAlign=Rata Kanan
rightToLeft=Kanan ke kiri
rotate=Putar
rotateTooltip=Klik dan seret untuk memutar, klik untuk memutar 90 derajat
rotation=Rotasi
rounded=Bulat
save=Simpan
saveAndExit=Simpan & Keluar
saveAs=Simpan sebagai
saveAsXmlFile=Simpan sebagai berkas XML?
saved=Tersimpan
saveDiagramsTo=Simpan diagram ke
saveLibrary403=Tidak cukup izin untuk mengedit pustaka ini
saveLibrary500=Terjadi kesalahan saat menyimpan pustaka
saving=Menyimpan
scratchpad=Scratchpad
scrollbars=Scrollbar
search=Cari
searchShapes=Cari Bentuk
selectAll=Pilih Semua
selectionOnly=Pilihan Saja
selectCard=Select Card
selectEdges=Pilih Tepi
selectFile=Pilih Berkas
selectFolder=Pilih Folder
selectFont=Pilih Fon
selectNone=Tidak Memilih
selectTemplate=Select Template
selectVertices=Pilih Verteks
sendMessage=Kirim
sendYourFeedbackToDrawIo=Kirim umpan balik ke draw.io
serviceUnavailableOrBlocked=Layanan tidak tersedia atau diblokir
sessionExpired=Sesi telah berakhir. Harap segarkan jendela peramban.
sessionTimeoutOnSave=Waktu sesi berakhir dan Anda telah terputus dari Google Drive. Tekan OKE untuk masuk dan menyimpan.
setAsDefaultStyle=Setel sebagai Gaya Default
shadow=Bayangan
shape=Bentuk
shapes=Bentuk
share=Bagikan
shareLink=Tautan untuk editan bersama
sharp=Tajam
show=Tampilkan
showStartScreen=Tampilkan Layar Awal
sidebarTooltip=Klik untuk memperluas. Seret dan jatuhkan bentuk ke dalam diagram. Shift+klik untuk mengubah pilihan. Alt+klik untuk menyisipkan dan menghubungkan.
signs=Tanda
signOut=Keluar
simple=Sederhana
simpleArrow=Panah Sederhana
size=Ukuran
solid=Padat
sourceSpacing=Spasi Sumber
south=Selatan
software=Perangkat Lunak
space=Spasi
spacing=Spasi
specialLink=Tautan Khusus
standard=Standar
starting=Memulai
straight=Lurus
strokeColor=Warna Garis
style=Gaya
subscript=Subskrip
summary=Ringkasan
superscript=Superskrip
support=Dukungan
sysml=SysML
tags=Tag
table=Tabel
tables=Tables
takeOver=Take Over
targetSpacing=Spasi Target
template=Templat
templates=Templat
text=Teks
textAlignment=Perataan Teks
textOpacity=Opasitas Teks
theme=Tema
timeout=Waktu habis
title=Judul
to=ke
toBack=Ke Belakang
toFront=Ke Depan
tooltips=Tooltip
top=Atas
topAlign=Rata Atas
topLeft=Kiri Atas
topRight=Kanan Atas
transparent=Transparan
transparentBackground=Latar Transparan
trello=Trello
tryAgain=Coba lagi
tryOpeningViaThisPage=Coba buka melalui halaman ini.
turn=Putar 90Â°
type=Tipe
twitter=Twitter
uml=UML
underline=Garis Bawah
undo=Batalkan
ungroup=Lepas Gabungan
unsavedChanges=Perubahan yang belum disimpan
unsavedChangesClickHereToSave=Perubahan yang belum disimpan. Klik di sini untuk menyimpan.
untitled=Tanpa Judul
untitledDiagram=Diagram Tanpa Judul
untitledLayer=Lapisan Tanpa Judul
untitledLibrary=Pustaka Tanpa Judul
unknownError=Galat tidak diketahui
updateFile=Pemutakhiran {1}
updatingDocument=Memutakhirkan Dokumen. Harap tunggu...
updatingPreview=Memutakhirkan Pratinjau. Harap tunggu
updatingSelection=Memutakhirkan Pilihan. Harap tunggu...
upload=Unggah
url=URL
useOffline=Use Offline
useRootFolder=Use root folder?
userManual=Panduan Pengguna
vertical=Vertikal
verticalFlow=Aliran Vertikal
verticalTree=Pohon Vertikal
view=Lihat
viewUrl=Tautan untuk melihat: {1}
voiceAssistant=Asisten Suara (beta)
warning=Peringatan
waypoints=Waypoint
west=Barat
width=Lebar
wiki=Wiki
wordWrap=Word Wrap
writingDirection=Arah Tulisan
yes=iya nih
yourEmailAddress=Alamat email Anda
zoom=Zum
zoomIn=Perbesar
zoomOut=Perkecil
basic=Dasar
businessprocess=Proses Bisnis
charts=Bagan
engineering=Teknik
flowcharts=Diagram Alir
gmdl=Desain Material
mindmaps=Peta Pikiran
mockups=Maket
networkdiagrams=Diagram Jaringan
nothingIsSelected=Tidak ada yang dipilih
other=Lainnya
softwaredesign=Desain Perangkat Lunak
venndiagrams=Diagram Venn
webEmailOrOther=Web, email, atau alamat internet lainnya
webLink=Tautan Web
wireframes=Wireframe
