# *DO NOT DIRECTLY EDIT THIS FILE, IT IS AUTOMATICALLY GENERATED AND IT IS BASED ON:*
# https://docs.google.com/spreadsheet/ccc?key=0AmQEO36liL4FdDJLWVNMaVV2UmRKSnpXU09MYkdGbEE
aboutDrawio=Acerca de draw.io
accessDenied=Acceso denegado
action=Action
actualSize=Tamaño real
add=Agregar
addedFile=Agregado {1}
addImages=Agregar imágenes
addImageUrl=Añadir URL de la imagen
addLayer=Agregar capa
addProperty=Agregar propiedad
address=Dirección
addToExistingDrawing=Agregar al dibujo existente
addWaypoint=Agregar punto de referencia
adjustTo=Ajustar a
advanced=Avanzado
align=Alinear
alignment=Alineación
allChangesLost=¡Se perderán todos los cambios!
allPages=Todas las páginas
allProjects=Todos los proyectos
allSpaces=Todos los espacios
allTags=Todas las etiquetas
anchor=Ancla
android=Android
angle=Ángulo
arc=Arc
areYouSure=¿Está seguro?
ensureDataSaved=Por favor, asegúrese de que sus datos estén guardados antes de cerrar.
allChangesSaved=Se han guardado todos los cambios
allChangesSavedInDrive=Se han guardado todos los cambios en Drive
allowPopups=Permitir pop-ups para evitar este diálogo.
allowRelativeUrl=Allow relative URL
alreadyConnected=Los nodos ya están conectados
apply=Aplicar
archiMate21=ArchiMate 2.1
arrange=Organizar
arrow=Flecha
arrows=Flechas
asNew=Como nuevo
atlas=Atlas
author=Autor
authorizationRequired=Autorización requerida
authorizeThisAppIn=Autorizar esta aplicación en {1}:
authorize=Autorizar
authorizing=Autorizando
automatic=Automático
autosave=Guardar automático
autosize=Dimensionar automáticamente
attachments=Adjuntos
aws=AWS
aws3d=AWS 3D
azure=Azure
background=Fondo
backgroundColor=Color de fondo
backgroundImage=Imagen de fondo
basic=Básico
blankDrawing=Dibujo en blanco
blankDiagram=Diagrama en blanco
block=Bloque
blockquote=Cita de Bloque
blog=Blog
bold=Negrita
bootstrap=Bootstrap
border=Border
borderColor=Color del borde
borderWidth=Ancho del borde
bottom=Abajo
bottomAlign=Alineación inferior
bottomLeft=Abajo a la izquierda
bottomRight=Abajo a la derecha
bpmn=BPMN
browser=Navegador
bulletedList=Lista con viñetas
business=Negocio
busy=Operación en progreso
cabinets=Gabinetes
cancel=Cancelar
center=Centrar
cannotLoad=Los intentos de carga fallaron. Por favor, inténtelo nuevamente más tarde.
cannotLogin=Los intentos de inicio de sesión fallaron. Por favor, inténtelo nuevamente más tarde.
cannotOpenFile=No se puede abrir el archivo
change=Cambiar
changeOrientation=Cambiar orientación
changeUser=Cambiar usuario
changesNotSaved=Los cambios no han sido guardados
chatJoined={1} se ha unido
chatLeft={1} se ha ido
chatWindowTitle=Chat
chooseAnOption=Elegir una opción
chromeApp=Aplicación Chrome
compressed=Comprimido
commitMessage=Confirmar mensaje
csv=CSV
dark=Dark
draftFound=Se encontró un borrador para '{1}'. Cárguelo en el editor o descártelo para continuar.
dragAndDropNotSupported=La opción de arrastrar y soltar no está soportada para las imágenes. ¿En lugar de eso, le gustaría importar?
dropboxCharsNotAllowed=Los siguientes caracteres no están permitidos: \ / : ? * " |
check=Verificar
circle=Círculo
cisco=Cisco
classic=Clásico
clearDefaultStyle=Quitar estilo predeterminado
clearWaypoints=Quitar punto de referencia
clipart=Clipart
close=Cerrar
collaborator=Colaborador
collaborators=Colaboradores
collapse=Reducir
collapseExpand=Reducir/Expandir
collapse-expand=Haga clic para reducir/expandir \nShift+clic para mover los vecinos\nAlt+clic para proteger el tamaño del grupo
collapsible=Reducible
comic=Comic
comment=Comentario
commentsNotes=Comentarios/Notas
compress=Compress
connect=Conectar
connecting=Conectando
connectWithDrive=Conectar con Google Drive
connection=Conexión
connectionArrows=Flechas de conexión
connectionPoints=Puntos de conexión
constrainProportions=Restringir proporciones
containsValidationErrors=Contiene errores de validación
copiedToClipboard=Copiado al portapapeles
copy=Copiar
copyConnect=Copiar al conectar
copyOf=Copia de {1}
copyOfDrawing=Copia del dibujo
copySize=Copy Size
copyStyle=Copiar estilo
create=Crear
createNewDiagram=Crear nuevo diagrama
createRevision=Crear revisión
createShape=Crear forma
crop=Recortar
curved=Curvado
custom=Personalizar
current=Actual
cut=Cortar
dashed=Discontinuo
decideLater=Decidir más tarde
default=Predeterminado
delete=Borrar
deleteColumn=Borrar columna
deleteLibrary401=Los permisos son insuficientes para borrar esta biblioteca
deleteLibrary404=La biblioteca seleccionada no pudo ser encontrada
deleteLibrary500=Error al borrar la biblioteca
deleteLibraryConfirm=Usted va a borrar permanentemente esta biblioteca. ¿Está seguro que desea hacer esto?
deleteRow=Eliminar fila
description=Descripción
device=Dispositivo
diagram=Diagrama
diagramContent=Contenido del diagrama
diagramLocked=El diagrama ha sido bloqueado para evitar la pérdida de datos.
diagramLockedBySince=The diagram is locked by {1} since {2} ago
diagramName=Nombre del diagrama
diagramIsPublic=El diagrama es público
diagramIsNotPublic=El diagrama no es público
diamond=Diamante
diamondThin=Diamante (fino)
didYouKnow=¿Sabía que...?
direction=Dirección
discard=Descartar
discardChangesAndReconnect=Descartar cambios y reconectar
googleDriveMissingClickHere=¿No encuentra Google Drive? ¡Haga clic aquí!
discardChanges=Descartar cambios
disconnected=Desconectado
distribute=Distribuir
done=Hecho
dotted=Punteado
doubleClickOrientation=Haga doble clic para cambiar la orientación
doubleClickTooltip=Haga doble clic para insertar texto
doubleClickChangeProperty=Haga doble clic para cambiar el nombre de la propiedad
download=Descargar
downloadDesktop=Download draw.io Desktop
downloadAs=Descargar como
clickHereToSave=Haga clic aquí para guardar.
draftDiscarded=Borrador descartado
draftSaved=Borrador guardado
dragElementsHere=Arrastrar elementos aquí
dragImagesHere=Arrastrar imágenes o URL aquí
dragUrlsHere=Arrastrar URLs aquí
draw.io=draw.io
drawing=Dibujo{1}
drawingEmpty=El dibujo está vacío
drawingTooLarge=El dibujo es demasiado grande
drawioForWork=Draw.io para Gsuite
dropbox=Dropbox
duplicate=Duplicar
duplicateIt=Duplicar {1}
divider=Separador
dx=Dx
dy=Dy
east=Este
edit=Editar
editData=Editar datos
editDiagram=Editar diagrama
editGeometry=Editar geometría
editImage=Editar imagen
editImageUrl=Editar URL de la imagen
editLink=Editar enlace
editShape=Editar forma
editStyle=Editar estilo
editText=Editar texto
editTooltip=Editar información de la herramienta
glass=Vidrio
googleImages=Imágenes de Google
imageSearch=Búsqueda de imágenes
eip=EIP
embed=Insertar
embedImages=Insertar imágenes
mainEmbedNotice=Pegar esto en la página
electrical=Eléctrico
ellipse=Ellipse
embedNotice=Pegar esto una vez al final de la página
enterGroup=Ingresar grupo
enterName=Ingresar nombre
enterPropertyName=Ingresar nombre de la propiedad
enterValue=Ingresar valor
entityRelation=Relación de la entidad
error=Error
errorDeletingFile=Error al borrar el archivo
errorLoadingFile=Error al cargar el archivo
errorRenamingFile=Error al renombrar el archivo.
errorRenamingFileNotFound=Error al renombrar el archivo. No se encontró el archivo.
errorRenamingFileForbidden=Error al renombrar el archivo. Derechos de acceso insuficientes.
errorSavingDraft=Error al guardar el borrador
errorSavingFile=Error al guardar el archivo
errorSavingFileUnknown=Error al autorizar los servidores de Google. Por favor, refresque la página para reintentar.
errorSavingFileForbidden=Error al guardar el archivo. Derechos de acceso insuficientes.
errorSavingFileNameConflict=No se pudo guardar el diagrama. La página actual ya contiene el archivo llamado '{1}'.
errorSavingFileNotFound=Error al guardar el archivo. No se ha encontrado el archivo.
errorSavingFileReadOnlyMode=Could not save diagram while read-only mode is active.
errorSavingFileSessionTimeout=Su sesión ha terminado. Por favor, <a target='_blank' href='{1}'>{2}</a> y vuelva a esta pestaña para intentar guardar nuevamente.
errorSendingFeedback=Error al enviar opiniones.
errorUpdatingPreview=Error al actualizar la vista previa.
exit=Salir
exitGroup=Salir del grupo
expand=Expandir
export=Exportar
exporting=Exportando
exportAs=Exportar como
exportOptionsDisabled=Las opciones para exportar están deshabilitadas
exportOptionsDisabledDetails=El propietario ha deshabilitado las opciones de descargar, imprimir o copiar para los comentadores u observadores de este archivo.
extras=Extras
facebook=Facebook
failedToSaveTryReconnect=Falló al guardar, intentando reconectar
featureRequest=Solicitud de características
feedback=Feedback
feedbackSent=Su opinión ha sido enviada exitosamente.
floorplans=Planos
file=Archivo
fileChangedOverwrite=El archivo fue cambiado. ¿Sobrescribir los cambios?
overwrite=Sobrescribir
filename=Nombre de archivo
fileExists=El archivo ya existe
fileNearlyFullSeeFaq=Archivo casi lleno, por favor vea las Preguntas Frecuentes
fileNotFound=Archivo no encontrado
repositoryNotFound=Repositorio no encontrado
fileNotFoundOrDenied=No se ha encontrado el archivo. No existe o usted no tiene permiso de lectura.
fileNotLoaded=Archivo no cargado
fileNotSaved=Archivo no guardado
fileOpenLocation=¿Cómo le gustaría abrir este/os archivo/s?
fileWillBeSavedInAppFolder={1} se guardará en la carpeta de aplicaciones.
fill=Relleno
fillColor=Color del relleno
filterCards=Filter Cards
find=Encontrar
fit=Ajustar
fitContainer=Redimensionar contenedor
fitIntoContainer=Ajustar al contenedor
fitPage=Ajustar página
fitPageWidth=Ajustar ancho de página
fitTo=Ajustar a
fitToSheetsAcross=hoja(s) a lo largo de
fitToBy=por
fitToSheetsDown=hoja(s) para abajo
fitTwoPages=Dos páginas
fitWindow=Ajustar a la ventana
flip=Voltear
flipH=Voltear horizontalmente
flipV=Voltear verticalmente
flowchart=Diagrama de flujo
folder=Carpeta
font=Fuente
fontColor=Color de la fuente
fontFamily=Familia de la fuente
fontSize=Tamaño de la fuente
forbidden=Usted no está autorizado para acceder a este archivo
format=Formato
formatPanel=Panel de formato
formatted=Formateado
formattedText=Texto formateado
formatPng=PNG
formatGif=GIF
formatJpg=JPEG
formatPdf=PDF
formatSql=SQL
formatSvg=SVG
formatHtmlEmbedded=HTML
formatSvgEmbedded=SVG (con XML)
formatVsdx=VSDX
formatVssx=VSSX
formatXmlPlain=XML (Normal)
formatXml=XML
forum=Foros de discusión/ayuda
fromTemplate=Desde la plantilla
fromTemplateUrl=Desde la URL de la plantilla
fromText=Desde el texto
fromUrl=Desde la URL
fromThisPage=Desde esta página
fullscreen=Pantalla completa
gap=Gap
gcp=GCP
general=General
github=GitHub
gliffy=Gliffy
global=Global
googleDocs=Google Docs
googleDrive=Google Drive
googleGadget=Google Gadget
googlePlus=Google+
googleSites=Google Sites
gradient=Gradiente
gradientColor=Color
grid=Cuadrícula
gridColor=Color de la cuadrícula
gridSize=Tamaño de la cuadrícula
group=Agrupar
guides=Guías
hateApp=Odio draw.io
heading=Encabezado
height=Altura
help=Ayuda
helpTranslate=Ayúdenos a traducir esta aplicación
hide=Ocultar
hideIt=Ocultar {1}
hidden=Oculto
home=Inicio
horizontal=Horizontal
horizontalFlow=Flujo horizontal
horizontalTree=Árbol horizontal
howTranslate=¿Cuán buena es la traducción en su idioma?
html=HTML
htmlText=Texto HTML
id=ID
iframe=IFrame
ignore=Ignorar
image=Imagen
imageUrl=URL de la imagen
images=Imágenes
imagePreviewError=Esta imagen no pudo ser cargada para la previsualización. Por favor, verifique la URL.
imageTooBig=La imagen es demasiado grande
imgur=Imgur
import=Importar
importFrom=Importar desde
includeCopyOfMyDiagram=Incluir una copia de mi diagrama
increaseIndent=Incrementar sangría
decreaseIndent=Reducir sangría
insert=Insertar
insertColumnBefore=Insertar columna a la izquierda
insertColumnAfter=Insertar columna a la derecha
insertEllipse=Insertar elipse
insertImage=Insertar imagen
insertHorizontalRule=Insertar regla horizontal
insertLink=Insertar enlace
insertPage=Insertar página
insertRectangle=Insertar rectángulo
insertRhombus=Insert Rhombus
insertRowBefore=Insertar fila arriba
insertRowAfter=insertar fila abajo
insertText=Insertar texto
inserting=Insertando
invalidFilename=Los nombres de los diagramas no deben contener los siguientes caracteres: \ / | : ; { } < > & + ? = "
invalidLicenseSeeThisPage=Su licencia es inválida, por favor vea esta <a target="_blank" href="https://support.draw.io/display/DFCS/Licensing+your+draw.io+plugin">página</a>.
invalidName=Nombre inválido
invalidOrMissingFile=Archivo inválido o no encontrado
invalidPublicUrl=URL pública inválida
isometric=Isométrico
ios=iOS
italic=Cursiva
kennedy=Kennedy
keyboardShortcuts=Atajos de teclado
layers=Capas
landscape=Orientación horizontal
language=Idioma
leanMapping=Mapeo Lean
lastChange=El último cambio fue hace {1}
lessThanAMinute=menos de un minuto
licensingError=Error de licencia
licenseHasExpired=La licencia para {1} ha expirado en {2}. Haga clic aquí.
licenseWillExpire=La licencia para {1} expirará en {2}. Haga clic aquí.
lineJumps=Line jumps
linkAccountRequired=Se requiere una cuenta de Google para ver el enlace si el diagrama no es público.
linkText=Texto del enlace
list=Lista
minute=minuto
minutes=minutos
hours=horas
days=días
months=meses
years=años
restartForChangeRequired=Los cambios tendrán efecto después de refrescar la página.
laneColor=Color del carril
lastModified=Última modificación
layout=Diseño
left=Izquierda
leftAlign=Alineación a la izquierda
leftToRight=De izquierda a derecha
libraryTooltip=Arrastre y suelte las formas aquí o clic + para insertar. Doble clic para editar.
lightbox=Caja de luz
line=Línea
lineend=Final de línea
lineheight=Altura de la línea
linestart=Comienzo de línea
linewidth=Ancho de línea
link=Enlace
links=Enlaces
loading=Cargando
lockUnlock=Bloquear/Desbloquear
loggedOut=Desconectado
logIn=ingresar
loveIt=Me encanta {1}
lucidchart=Lucidchart
maps=Mapas
mathematicalTypesetting=Composición tipográfica matemática
makeCopy=Hacer una copia
manual=Manual
middle=Medio
minimal=Minimal
misc=Miscelánea
mockups=Bosquejos
modificationDate=Fecha de modificación
modifiedBy=Modificado por
more=Más
moreResults=Más resultados
moreShapes=Más formas
move=Mover
moveToFolder=Mover a la carpeta
moving=Moviendo
moveSelectionTo=Mover selección a {1}
name=Nombre
navigation=Navegación
network=Red
networking=Red
new=Nuevo
newLibrary=Nueva biblioteca
nextPage=Próxima página
no=No
noAttachments=No se encontraron adjuntos
noColor=Sin color
noFiles=Sin archivos
noFileSelected=Ningún archivo seleccionado
noLibraries=Ninguna biblioteca encontrada
noMoreResults=No hay más resultados
none=Ninguno
noOtherViewers=Ningún otro observador
noPlugins=No hay plugins
noPreview=No hay vista previa
noResponse=No hay respuesta del servidor
noResultsFor=No hay resultados para '{1}'
noRevisions=Sin revisiones
noSearchResults=No se encontró ningún resultado de búsqueda
noPageContentOrNotSaved=No se encontró ningún ancla en esta página o aún no ha sido guardada
normal=Normal
north=Norte
notADiagramFile=No es un archivo de diagrama
notALibraryFile=No es un archivo de biblioteca
notAvailable=No disponible
notAUtf8File=No es un archivo UTF-8
notConnected=No conectado
note=Nota
notUsingService=¿No utiliza {1}?
numberedList=Lista numerada
offline=Desconectado
ok=OK
oneDrive=OneDrive
online=En línea
opacity=Opacidad
open=Abrir
openArrow=Flecha abierta
openExistingDiagram=Abrir diagrama existente
openFile=Abrir archivo
openFrom=Abrir desde
openLibrary=Abrir biblioteca
openLibraryFrom=Abrir biblioteca desde
openLink=Abrir enlace
openInNewWindow=Abrir en ventana nueva
openInThisWindow=Abrir en esta ventana
openIt=Abrir {1}
openRecent=Abrir reciente
openSupported=Los formatos soportados son archivos guardados desde este software (.xml), .vsdx y .gliffy
options=Opciones
organic=Orgánico
orthogonal=Ortogonal
otherViewer=otro observador
otherViewers=otros observadores
outline=Vista general
oval=Óvalo
page=Página
pageContent=Contenido de la página
pageNotFound=Página no encontrada
pageWithNumber=Página-{1}
pages=Páginas
pageView=Vista de la página
pageSetup=Configuración de la Página
pageScale=Escala de la página
pan=Panorámica
panTooltip=Espacio+Arrastrar para panear
paperSize=Tamaño del papel
pattern=Patrón
paste=Pegar
pasteHere=Pegar aquí
pasteSize=Paste Size
pasteStyle=Pegar estilo
perimeter=Perímetro
permissionAnyone=Cualquiera puede editar
permissionAuthor=Sólo yo puedo editar
pickFolder=Seleccionar una carpeta
pickLibraryDialogTitle=Seleccionar biblioteca
publicDiagramUrl=URL pública del diagrama
placeholders=Parámetro de sustitución
plantUml=PlantUML
plugins=Plugins
pluginUrl=URL del plugin
pluginWarning=La página ha solicitado cargar el/los siguiente/s plugin/s:\n \n {1}\n \n ¿Le gustaría cargar este/os plugin/s ahora?\n \n NOTA: Permita que los plugins corran solamente si usted entiende por completo las consecuencias de seguridad que esto implica.\n
plusTooltip=Haga clic para conectar y clonar (ctrl+clic para clonar, shift+clic para conectar). Arrastre para conectar (ctrl+arrastrar para clonar).
portrait=Orientación vertical
position=Posición
posterPrint=Impresión de póster
preferences=Preferencias
preview=Vista previa
previousPage=Página previa
print=Imprimir
printAllPages=Imprimir todas las páginas
procEng=Ingeniería de Procesos
project=Proyecto
priority=Prioridad
properties=Propiedades
publish=Publicar
quickStart=Vídeo de inicio rápido
rack=Rack
radialTree=Árbol radial
readOnly=Sólo lectura
reconnecting=Reconectando
recentlyUpdated=Actualizado recientemente 
recentlyViewed=Visto recientemente 
rectangle=Rectangle
redirectToNewApp=Este archivo fue creado o modificado en una versión más reciente de esta aplicación. Usted será redirigido ahora.
realtimeTimeout=Parece que ha hecho algunos cambios mientras estaba desconectado. Lo sentimos, estos cambios no pueden ser guardados.
redo=Rehacer
refresh=Refrescar
regularExpression=Expresión Regular
relative=Relative
relativeUrlNotAllowed=Relative URL not allowed
rememberMe=Recuérdeme
rememberThisSetting=Recordar esta configuración
removeFormat=Borrar formato
removeFromGroup=Eliminar del grupo
removeIt=Eliminar {1}
removeWaypoint=Eliminar punto de referencia
rename=Renombrar
renamed=Renombrado
renameIt=Renombrar {1}
renaming=Renombrando
replace=Reemplazar
replaceIt={1} ya existe. ¿Desea reemplazarlo?
replaceExistingDrawing=Reemplazar el dibujo existente
required=requerido
reset=Restablecer
resetView=Restablecer vista
resize=Redimensionar
resizeLargeImages=Do you want to resize large images to make the application run faster?
retina=Retina
responsive=Receptivo
restore=Restaurar
restoring=Restaurando
retryingIn=Reintentando en {1} segundo(s)
retryingLoad=Carga fallida. Reintentando...
retryingLogin=Tiempo de inicio de sesión agotado. Reintentando...
reverse=Revertir
revision=Revisión
revisionHistory=Historial de revisiones
rhombus=Rhombus
right=Derecha
rightAlign=Alinear a la derecha
rightToLeft=De derecha a izquierda
rotate=Rotar
rotateTooltip=Haga clic y arrastre para rotar, haga clic para girar 90 grados
rotation=Rotación
rounded=Redondeado
save=Guardar
saveAndExit=Guardar y salir
saveAs=Guardar como
saveAsXmlFile=¿Guardar como archivo XML?
saved=Guardado
saveDiagramsTo=Guardar diagramas en
saveLibrary403=Permisos insuficientes para editar esta biblioteca
saveLibrary500=Hubo un error mientras se guardaba la biblioteca
saving=Guardando
scratchpad=Bloc de notas
scrollbars=Barras de desplazamiento
search=Buscar
searchShapes=Buscar formas
selectAll=Seleccionar todo
selectionOnly=Seleccionar solo
selectCard=Select Card
selectEdges=Seleccionar bordes
selectFile=Seleccionar archivo
selectFolder=Seleccionar carpeta
selectFont=Seleccionar fuente
selectNone=Seleccionar ninguno
selectTemplate=Select Template
selectVertices=Seleccionar vértices
sendMessage=Enviar
sendYourFeedbackToDrawIo=Envíe su opinión a draw.io
serviceUnavailableOrBlocked=Servicio no disponible o bloqueado
sessionExpired=Su sesión ha expirado. Por favor, refresque la ventana del navegador.
sessionTimeoutOnSave=El tiempo límite de su sesión ha terminado y usted ha sido desconectado de Google Drive. Pulse OK para acceder y guardar.
setAsDefaultStyle=Establecer como estilo predeterminado
shadow=Sombra
shape=Forma
shapes=Formas
share=Compartir
shareLink=Enlace para edición compartida.
sharp=Filoso
show=Mostrar
showStartScreen=Mostrar pantalla de inicio
sidebarTooltip=Clic para expandir. Arrastre y suelte formas en el diagrama. Shift+clic para cambiar la selección. Alt+clic para insertar y conectar.
signs=Símbolos
signOut=Cerrar sesión
simple=Simple
simpleArrow=Flecha simple
size=Tamaño
solid=Sólida
sourceSpacing=Espaciado entre fuentes
south=Sur
software=Software
space=Espacio
spacing=Espaciado
specialLink=Enlace especial
standard=Estándar
starting=Iniciando
straight=Recto
strokeColor=Color de línea
style=Estilo
subscript=Subíndice
summary=Resumen
superscript=Superíndice
support=Soporte
sysml=SysML
tags=Etiquetas
table=Tabla
tables=Tablas
takeOver=Take Over
targetSpacing=Espaciado del objetivo
template=Plantilla
templates=Plantillas
text=Texto
textAlignment=Alineación del texto
textOpacity=Opacidad del texto
theme=Tema
timeout=Tiempo límite
title=Título
to=a
toBack=Hacia atrás
toFront=Hacia adelante
tooltips=Información de la herramienta
top=Arriba
topAlign=Alinear hacia arriba
topLeft=Arriba a la izquierda
topRight=Arriba a la derecha
transparent=Transparente
transparentBackground=Fondo transparente
trello=Trello
tryAgain=Intente otra vez
tryOpeningViaThisPage=Intente abrir a través de esta página
turn=Rotar 90º
type=Tipo
twitter=Twitter
uml=UML
underline=Subrayar
undo=Deshacer
ungroup=Desagrupar
unsavedChanges=Cambios no guardados
unsavedChangesClickHereToSave=Cambios no guardados. Haga clic aquí para guardar.
untitled=Sin título
untitledDiagram=Diagrama sin título
untitledLayer=Capa sin título
untitledLibrary=Biblioteca sin título
unknownError=Error desconocido
updateFile=Actualizar {1}
updatingDocument=Actualizando documento. Por favor, espere...
updatingPreview=Actualizando vista previa. Por favor, espere...
updatingSelection=Actualizando selección. Por favor, espere...
upload=Subir
url=URL
useOffline=Use Offline
useRootFolder=Use root folder?
userManual=Manual de usuario
vertical=Vertical
verticalFlow=Flujo vertical
verticalTree=Árbol vertical
view=Vista
viewUrl=Enlace para visualizar: {1}
voiceAssistant=Asistente de voz (beta)
warning=Advertencia
waypoints=Punto de referencia
west=Oeste
width=Ancho
wiki=Wiki
wordWrap=Cambio de línea
writingDirection=Dirección de escritura
yes=Sí
yourEmailAddress=Su dirección de correo electrónico
zoom=Zoom
zoomIn=Acercar
zoomOut=Alejar
basic=Básico
businessprocess=Procesos de negocio
charts=Gráficos
engineering=Ingeniería
flowcharts=Diagramas de flujo
gmdl=Diseño del material
mindmaps=Mapas mentales
mockups=Bosquejos
networkdiagrams=Diagramas de red
nothingIsSelected=No hay nada seleccionado
other=Otros
softwaredesign=Diseño de software
venndiagrams=Diagramas de Venn
webEmailOrOther=Web, correo electrónico o cualquier otra dirección de internet
webLink=Enlace web
wireframes=Esquemas
