# *DO NOT DIRECTLY EDIT THIS FILE, IT IS AUTOMATICALLY GENERATED AND IT IS BASED ON:*
# https://docs.google.com/spreadsheet/ccc?key=0AmQEO36liL4FdDJLWVNMaVV2UmRKSnpXU09MYkdGbEE
aboutDrawio=О сервисе draw.io
accessDenied=Доступ запрещён
action=Действие
actualSize=Фактический размер
add=Добавить
addedFile=Добавлено {1}
addImages=Добавить изображения
addImageUrl=Добавить ссылку на изображение
addLayer=Добавить слой
addProperty=Добавить свойство
address=Адрес
addToExistingDrawing=Добавить к существующей диаграмме
addWaypoint=Добавить опорную точку
adjustTo=Привязать к
advanced=Расширенные
align=Выровнять
alignment=Выравнивание
allChangesLost=Все изменения будут потеряны!
allPages=Все страницы
allProjects=Все проекты
allSpaces=Все области
allTags=Все теги
anchor=Якоря
android=Android
angle=Угол
arc=Дуга
areYouSure=Вы уверены?
ensureDataSaved=Пожалуйста, перед закрытием убедитесь, что ваши данные сохранены.
allChangesSaved=Все изменения сохранены
allChangesSavedInDrive=Все изменения сохранены на диске
allowPopups=Разрешите всплывающие окна, чтобы убрать этот диалог.
allowRelativeUrl=Разрешить относительные адреса
alreadyConnected=Узлы уже соединены
apply=Применить
archiMate21=ArchiMate 2.1
arrange=Расположить
arrow=Стрелка
arrows=Стрелки
asNew=Как новое
atlas=Атлас
author=Автор
authorizationRequired=Требуется авторизация
authorizeThisAppIn=Авторизуйте это приложение в {1}:
authorize=Авторизовать
authorizing=Авторизация
automatic=Автоматически
autosave=Автосохранение
autosize=Авто размер
attachments=Вложения
aws=AWS
aws3d=AWS 3D
azure=Azure
background=Фон
backgroundColor=Цвет фона
backgroundImage=Картинка фона
basic=Базовые
blankDrawing=Новый документ
blankDiagram=Пустая диаграмма
block=Блок
blockquote=Цитата
blog=Блог
bold=Полужирный
bootstrap=Bootstrap
border=Граница
borderColor=Цвет границы
borderWidth=Толщина границы
bottom=Низ
bottomAlign=По нижнему краю
bottomLeft=Левый нижний
bottomRight=Правый нижний
bpmn=BPMN
browser=Браузер
bulletedList=Маркированный список
business=Бизнес
busy=Операция выполняется
cabinets=Шкафы и стойки
cancel=Отмена
center=По центру
cannotLoad=Загрузка не удалась. Пожалуйста, попробуйте позже.
cannotLogin=Не удалось войти. Пожалуйста, попробуйте позже.
cannotOpenFile=Невозможно открыть файл
change=Изменить
changeOrientation=Изменить ориентацию
changeUser=Сменить пользователя
changesNotSaved=Изменения не сохранены
chatJoined={1} присоединился
chatLeft={1} вышел
chatWindowTitle=Чат
chooseAnOption=Выберите вариант
chromeApp=Приложение Chrome
compressed=Сжато
commitMessage=Сообщение при коммите
csv=CSV
dark=Темная
draftFound=Был обнаружен черновик '{1}'. Загрузите его в редактор или откажитесь, чтобы продолжить.
dragAndDropNotSupported=Перетаскивание изображений не поддерживается. Импортировать изображение?
dropboxCharsNotAllowed=Следующие символы не допускаются: \ / : ? * " |
check=Проверить
circle=Круг
cisco=Cisco
classic=Классический
clearDefaultStyle=Очистить стиль по умолчанию
clearWaypoints=Очистить опорные точки
clipart=Клипарт
close=Закрыть
collaborator=Помощник
collaborators=Помощники
collapse=Свернуть
collapseExpand=Свернуть/Развернуть
collapse-expand=Кликните, чтобы свернуть/развернуть\nShift+клик – перемещение соседних элементов\nAlt+клик - сохранить размер группы
collapsible=Сворачиваемый
comic=Рукописный
comment=Комментарий
commentsNotes=Комментарии/Заметки
compress=Compress
connect=Соединить
connecting=Соединение
connectWithDrive=Связать с Google Drive
connection=Соединение
connectionArrows=Стрелки соединения
connectionPoints=Точки соединения
constrainProportions=Ограничить пропроции
containsValidationErrors=Содержит ошибки проверки
copiedToClipboard=Скопировано в буфер обмена
copy=Копировать
copyConnect=Копировать при соединении
copyOf=Копия {1}
copyOfDrawing=Копия документа
copySize=Копировать размер
copyStyle=Копировать стиль
create=Создать
createNewDiagram=Создать новую диаграмму
createRevision=Создать ревизию
createShape=Создать фигуру
crop=Обрезать по содержимому
curved=Кривая
custom=Настроить
current=Текущий
cut=Вырезать
dashed=Штриховой пунктир
decideLater=Выбрать позже
default=По умолчанию
delete=Удалить
deleteColumn=Удалить столбец
deleteLibrary401=Не хватает полномочий для удаления библиотеки
deleteLibrary404=Выбранная библиотека не найдена
deleteLibrary500=Ошибка при удалении библиотеки
deleteLibraryConfirm=Библиотека будет удалена без возможности восстановления. Вы точно хотите это сделать?
deleteRow=Удалить строку
description=Описание
device=Это устройство
diagram=Диаграмма
diagramContent=Содержимое диаграммы
diagramLocked=Диаграмма была заблокирована для предотвращения потери данных.
diagramLockedBySince=Диаграмма заблокирована {1} {2} назад
diagramName=Название диаграммы
diagramIsPublic=Диаграмма является публичной
diagramIsNotPublic=Диаграмма не является публичной
diamond=Ромб
diamondThin=Ромб (тонкий)
didYouKnow=Знали ли вы...
direction=Направление
discard=Отказаться
discardChangesAndReconnect=Отказаться от изменений и подключиться заново
googleDriveMissingClickHere=Нет Google Drive? Нажмите сюда!
discardChanges=Отказаться от изменений
disconnected=Отсоединено
distribute=Распределить
done=Готово
dotted=Точки
doubleClickOrientation=Дважды щелкните мышью, чтобы изменить ориентацию
doubleClickTooltip=Дважды щелкните мышью, чтобы вставить текст
doubleClickChangeProperty=Дважды щелкните мышью, чтобы изменить название свойства
download=Скачать
downloadDesktop=Download draw.io Desktop
downloadAs=Скачать как
clickHereToSave=Щелкните здесь, чтобы сохранить.
draftDiscarded=Черновик удален
draftSaved=Черновик сохранен
dragElementsHere=Перетащите сюда элементы
dragImagesHere=Перетащите сюда изображения или ссылки
dragUrlsHere=Перетащите сюда ссылки
draw.io=draw.io
drawing=Рисунок{1}
drawingEmpty=Документ пуст
drawingTooLarge=Документ слишком большой
drawioForWork=Draw.io для GSuite
dropbox=Dropbox
duplicate=Дублировать
duplicateIt=Дублировать {1}
divider=Разделитель
dx=Dx
dy=Dy
east=Восток
edit=Правка
editData=Редактировать данные
editDiagram=Редактировать диаграмму
editGeometry=Редактировать геометрию
editImage=Редактировать изображение
editImageUrl=Редактировать ссылку на изображение
editLink=Редактировать ссылку
editShape=Редактировать фигуру
editStyle=Редактировать стиль
editText=Редактировать текст
editTooltip=Редактировать подсказку
glass=Стекло
googleImages=Google Images
imageSearch=Поиск изображения
eip=EIP
embed=Поместить
embedImages=Встроить изображения
mainEmbedNotice=Скопируйте это на страницу
electrical=Электрические схемы
ellipse=Ellipse
embedNotice=Добавьте один раз в конец страницы
enterGroup=Введите группу
enterName=Введите название
enterPropertyName=Введите название свойства
enterValue=Введите значение
entityRelation=Сущность–связь
error=Ошибка
errorDeletingFile=Ошибка при удалении файла
errorLoadingFile=Ошибка при загрузке файла
errorRenamingFile=Ошибка при переименовании файла
errorRenamingFileNotFound=Ошибка при переименовании файла. Файл не найден.
errorRenamingFileForbidden=Ошибка при переименовании файла. Не хватает прав доступа.
errorSavingDraft=Ошибка при сохранении черновика
errorSavingFile=Ошибка при сохранении файла
errorSavingFileUnknown=Ошибка авторизации на сервере Google. Пожалуйста, обновите страницу, чтобы повторить попытку.
errorSavingFileForbidden=Ошибка сохранения файла. Не хватает прав доступа.
errorSavingFileNameConflict=Невозможно сохранить диаграмму. Страница уже содержит файл с названием '{1}'.
errorSavingFileNotFound=Ошибка при сохранении файла. Файл не найден.
errorSavingFileReadOnlyMode=Невозможно сохранить диаграмму до выхода из режима только для чтения
errorSavingFileSessionTimeout=Ваша сессия истекла. Для сохранения, пожалуйста, <a target='_blank' href='{1}'>{2}</a> и вернитесь на эту закладку.
errorSendingFeedback=Ошибка при отправке сообщения обратной связи.
errorUpdatingPreview=Ошибка при обновлении предпросмотра.
exit=Выйти
exitGroup=Выйти из группы
expand=Развернуть
export=Экспортировать
exporting=Экспорт
exportAs=Экспортировать как
exportOptionsDisabled=Возможности экспорта отключены
exportOptionsDisabledDetails=Владелец файла отключил возможности сохранения, печати или копирования данных при просмотре и комментировании этого файла.
extras=Дополнительно
facebook=Facebook
failedToSaveTryReconnect=Ошибка при сохранении, выполняется повторное подключение
featureRequest=Запрос новой возможности
feedback=Обратная связь
feedbackSent=Сообщение обратной связи успешно отправлено.
floorplans=Планы помещений
file=Файл
fileChangedOverwrite=Файл был изменен. Заменить измененный файл?
overwrite=Заменить
filename=Имя файла
fileExists=Файл уже существует
fileNearlyFullSeeFaq=Файл почти заполнен, пожалуйста, ознакомьтесь с FAQ
fileNotFound=Файл не найден
repositoryNotFound=Репозиторий не найден
fileNotFoundOrDenied=Файл не найден. Он не существует, или у вас нет доступа на чтение.
fileNotLoaded=Файл не загружен
fileNotSaved=Файл не сохранен
fileOpenLocation=Как вы хотите открыть эти файл(ы)?
fileWillBeSavedInAppFolder={1} будет сохранен в папке программы.
fill=Заливка
fillColor=Цвет заливки
filterCards=Фильтровать карточки
find=Найти
fit=Вписать
fitContainer=Изменить размер контейнера
fitIntoContainer=Вписать в контейнер
fitPage=По размеру страницы
fitPageWidth=По ширине страницы
fitTo=Вписать в
fitToSheetsAcross=страниц(ы) в ширину
fitToBy=на
fitToSheetsDown=страниц(ы) в высоту
fitTwoPages=две страницы
fitWindow=Вписать в окно
flip=Отразить
flipH=Отразить слева направо
flipV=Отразить сверху вниз
flowchart=Блок-схема
folder=Директория
font=Шрифт
fontColor=Цвет шрифта
fontFamily=Семейство шрифтов
fontSize=Размер шрифта
forbidden=У вас нет прав на доступ к данному файлу
format=Формат
formatPanel=Панель форматирования
formatted=Форматированный
formattedText=Форматированный текст
formatPng=PNG
formatGif=GIF
formatJpg=JPEG
formatPdf=PDF
formatSql=SQL
formatSvg=SVG
formatHtmlEmbedded=HTML
formatSvgEmbedded=SVG (с XML)
formatVsdx=VSDX
formatVssx=VSSX
formatXmlPlain=XML (стандартный)
formatXml=XML
forum=Обсуждение/Справочный форум
fromTemplate=Из шаблона
fromTemplateUrl=Из шаблона по ссылке
fromText=Из текста
fromUrl=По ссылке
fromThisPage=С этой страницы
fullscreen=Полный экран
gap=Gap
gcp=GCP
general=Общие
github=GitHub
gliffy=Gliffy
global=Глобальный
googleDocs=Google Docs
googleDrive=Google Drive
googleGadget=Google Gadget
googlePlus=Google+
googleSites=Google Sites
gradient=Градиент
gradientColor=Цвет
grid=Сетка
gridColor=Цвет сетки
gridSize=Шаг сетки
group=Группировать
guides=Направляющие
hateApp=Терпеть не могу draw.io
heading=Заголовок
height=Высота
help=Помощь
helpTranslate=Помогите нам перевести приложение
hide=Скрыть
hideIt=Скрыть {1}
hidden=Скрытый
home=На верхний уровень
horizontal=Горизонтально
horizontalFlow=Горизонтальный поток
horizontalTree=Горизонтальное дерево
howTranslate=Насколько хорошо приложение переведено на ваш язык?
html=HTML
htmlText=HTML текст
id=ID
iframe=IFrame
ignore=Игнорировать
image=Изображение
imageUrl=Ссылка на изображение
images=Изображения
imagePreviewError=Невозможно загрузить изображение. Пожалуйста, проверьте ссылку.
imageTooBig=Изображение слишком большое
imgur=Imgur
import=Импортировать
importFrom=Импортировать из
includeCopyOfMyDiagram=Вложить копию моей диаграммы
increaseIndent=Увеличить отступ
decreaseIndent=Уменьшить отступ
insert=Добавить
insertColumnBefore=Вставить столбец слева
insertColumnAfter=Вставить столбец справа
insertEllipse=Добавить эллипс
insertImage=Добавить изображение
insertHorizontalRule=Вставить горизонтальную направляющую
insertLink=Добавить ссылку
insertPage=Добавить страницу
insertRectangle=Добавить прямоугольник
insertRhombus=Добавить ромб
insertRowBefore=Вставить строку сверху
insertRowAfter=Вставить строку снизу
insertText=Добавить текст
inserting=Вставка
invalidFilename=Название диаграммы не может содержать следующие символы: \ / | : ; { < & + ? = "
invalidLicenseSeeThisPage=Ваша лицензия недействительна. Пожалуйста, посетите эту<a target="_blank" href="https://support.draw.io/display/DFCS/Licensing+your+draw.io+plugin">страницу</a>.
invalidName=Некорректное имя
invalidOrMissingFile=Файл поврежден или отсутствует
invalidPublicUrl=Некорректная ссылка
isometric=Изометрический
ios=iOS
italic=Курсив
kennedy=Кеннеди
keyboardShortcuts=Комбинации клавиш
layers=Слои
landscape=Альбомная
language=Язык
leanMapping=Потоки ценностей
lastChange=Последнее изменение {1} назад
lessThanAMinute=меньше минуты
licensingError=Ошибка лицензирования
licenseHasExpired=Лицензия на {1} истекла {2}. Нажмите здесь.
licenseWillExpire=Лицензия на {1} истекает {2}. Нажмите здесь.
lineJumps=Line jumps
linkAccountRequired=Если диаграмма не доступна для общего доступа, для просмотра понадобится войти в учетную запись Google.
linkText=Текст ссылки
list=Список
minute=минуту
minutes=минут
hours=часов
days=дней
months=месяцев
years=лет
restartForChangeRequired=Изменения вступят в силу после обновления страницы.
laneColor=Цвет дорожки
lastModified=Последнее изменение
layout=Расположение
left=Слева
leftAlign=По левому краю
leftToRight=Слева направо
libraryTooltip=Для добавления фигуры перенесите ее сюда при помощи мыши или нажмите «+». Дважды щелкните для редактирования.
lightbox=Галерея
line=Линия
lineend=Конец линии
lineheight=Высота линии
linestart=Начало линии
linewidth=Толщина линии
link=Ссылка
links=Ссылки
loading=Загрузка
lockUnlock=Блокировать/Разблокировать
loggedOut=Вышел
logIn=войти
loveIt=Обожаю {1}
lucidchart=Lucidchart
maps=Карты
mathematicalTypesetting=Математический набор
makeCopy=Создать копию
manual=Вручную
middle=Середина
minimal=Минималистичная
misc=Прочее
mockups=Макеты
modificationDate=Дата изменения
modifiedBy=Изменён
more=Больше
moreResults=Больше результатов
moreShapes=Больше фигур
move=Переместить
moveToFolder=Переместить в папку
moving=Перемещаю
moveSelectionTo=Переместить выбранное на {1}
name=Название
navigation=Навигация
network=Сеть
networking=Сети
new=Создать
newLibrary=Новая библиотека
nextPage=Следующая страница
no=нет
noAttachments=Вложения не найдены
noColor=Нет цвета
noFiles=Нет файлов
noFileSelected=Файл не выбран
noLibraries=Библиотеки не найдены
noMoreResults=Нет других результатов
none=Ничего
noOtherViewers=Нет других наблюдателей
noPlugins=Нет плагинов
noPreview=Нет предпросмотра
noResponse=Нет ответа от сервера
noResultsFor=Нет результатов для '{1}'
noRevisions=Нет ревизий
noSearchResults=Ничего не найдено
noPageContentOrNotSaved=На странице нет закладок или страница не была сохранена
normal=Обычный
north=Север
notADiagramFile=Не файл диаграммы
notALibraryFile=Не файл библиотеки
notAvailable=Недоступно
notAUtf8File=Кодировка файла отличается от UTF-8
notConnected=Не подключен
note=Заметка
notUsingService=Не хотите использовать {1}?
numberedList=Нумерованный список
offline=Оффлайн
ok=OK
oneDrive=OneDrive
online=Онлайн
opacity=Непрозрачность
open=Открыть
openArrow=Незакрашенная стрелка
openExistingDiagram=Открыть существующую диаграмму
openFile=Открыть файл
openFrom=Открыть из
openLibrary=Открыть библиотеку
openLibraryFrom=Открыть библиотеку из
openLink=Открыть ссылку
openInNewWindow=Открыть в новом окне
openInThisWindow=Открыть в этом окне
openIt=Открыть {1}
openRecent=Последние документы
openSupported=Поддерживаются файлы, созданные в этой программе (.xml), файлы .vsdx, .gliffy
options=Параметры
organic=Сетевая
orthogonal=Прямые углы
otherViewer=также просматривает
otherViewers=также просматривают
outline=Контур
oval=Овал
page=Страница
pageContent=Содержимое страницы
pageNotFound=Страница не найдена
pageWithNumber=Страница {1}
pages=Страницы
pageView=Вид страницы
pageSetup=Параметры страницы
pageScale=Масштаб страницы
pan=Панорама
panTooltip=Удерживайте нажатой клавишу "пробел" и перемещайте курсор для прокрутки диаграммы
paperSize=Размер бумаги
pattern=Шаблон
paste=Вставить
pasteHere=Вставить сюда
pasteSize=Вставить размер
pasteStyle=Вставить стиль
perimeter=По периметру
permissionAnyone=Редактирование разрешено всем
permissionAuthor=Редактировать могу только я
pickFolder=Выберите папку
pickLibraryDialogTitle=Выберите библиотеку
publicDiagramUrl=Общедоступная ссылка на диаграмму
placeholders=Плейсхолдеры
plantUml=PlantUML
plugins=Плагины
pluginUrl=URL плагина
pluginWarning=Страница пытается загрузить модуль(ли) расширения:\n \n {1}\n \n Загрузить эти модули сейчас?\n \n ПРИМЕЧАНИЕ: Разрешайте запуск плагинов только если вы полностью понимаете последствия для безопасности.\n
plusTooltip=Щелкните для создания связи и клонирования (клик+ctrl для клонирования, клик+shift для создания связи). Перетащите для создания связи (переместите с нажатым ctrl для клонирования).
portrait=Портретная
position=Положение
posterPrint=Постерная печать
preferences=Предпочтения
preview=Предпросмотр
previousPage=Предыдущая страница
print=Печать
printAllPages=Печать всех страниц
procEng=Процесс-инжиниринг
project=Проект
priority=Приоритет
properties=Свойства
publish=Опубликовать
quickStart=Видео-знакомство (англ.)
rack=Стойки и оборудование
radialTree=Радиальное дерево
readOnly=Только для чтения
reconnecting=Восстановление соединения
recentlyUpdated=Недавно обновлено
recentlyViewed=Недавно просмотрено
rectangle=Прямоугольник
redirectToNewApp=Файл был создан или изменен в более новой версии приложения. Сейчас вы будете перенаправлены.
realtimeTimeout=Похоже, вы внесли некоторые правки, пока не было соединения с сетью. Приносим свои извинения, но эти изменения не могут быть сохранены.
redo=Вернуть
refresh=Обновить
regularExpression=Регулярное выражение
relative=Относительный
relativeUrlNotAllowed=Использование относительных адресов запрещено
rememberMe=Запомнить меня
rememberThisSetting=Запомнить выбор
removeFormat=Очистить форматирование
removeFromGroup=Удалить из группы
removeIt=Удалить {1}
removeWaypoint=Удалить опорную точку
rename=Переименовать
renamed=Переименовано
renameIt=Переименовать {1}
renaming=Идет переименование
replace=Заменить
replaceIt={1} уже существует. Заменить?
replaceExistingDrawing=Заменить существующую диаграмму
required=обязательно
reset=Сбросить
resetView=Сбросить режим просмотра
resize=Изменить размер
resizeLargeImages=Уменьшить большие изображения для ускорения работы приложения?
retina=Retina
responsive=Отзывчивый
restore=Восстановить
restoring=Восстанавливается
retryingIn=Повторная попытка через {1}
retryingLoad=Загрузка не удалась. Пробуем еще раз...
retryingLogin=Время входа истекло. Пробуем еще раз...
reverse=Обратить
revision=Ревизия
revisionHistory=История изменений
rhombus=Ромб
right=Справа
rightAlign=По правому краю
rightToLeft=Справа налево
rotate=Повернуть
rotateTooltip=Нажмите и переместите для поворота, нажмите для поворота на 90 градусов
rotation=Повернуть
rounded=Скругленные углы
save=Сохранить
saveAndExit=Сохранить и выйти
saveAs=Сохранить как
saveAsXmlFile=Сохранить как файл XML?
saved=Сохранено
saveDiagramsTo=Сохранять диаграммы в
saveLibrary403=Недостаточно полномочий для редактирования библиотеки
saveLibrary500=Ошибка при сохранении библиотеки
saving=Идет сохранение
scratchpad=Избранные фигуры
scrollbars=Полосы прокрутки
search=Поиск
searchShapes=Поиск фигур
selectAll=Выбрать все
selectionOnly=Только выделение
selectCard=Выбрать карточку
selectEdges=Выбрать края
selectFile=Выберите файл
selectFolder=Выберите папку
selectFont=Выберите шрифт
selectNone=Сбросить выделение
selectTemplate=Выбрать шаблон
selectVertices=Выбрать вершины
sendMessage=Отправить
sendYourFeedbackToDrawIo=Отправьте ваш отзыв на draw.io
serviceUnavailableOrBlocked=Служба недоступна или заблокирована
sessionExpired=Время вашей сессии истекло. Пожалуйста, обновите окно браузера.
sessionTimeoutOnSave=Время вашей сессии истекло и вы были отключены от Google Drive. Нажмите ОК, чтобы войти снова и сохранить изменения.
setAsDefaultStyle=Установить как стиль по умолчанию
shadow=Тень
shape=Фигура
shapes=Фигуры
share=Общий доступ
shareLink=Ссылка для совместного редактирования
sharp=Острые углы
show=Показать
showStartScreen=Показать начальный экран
sidebarTooltip=Нажмите, чтобы развернуть. Перетащите фигуры на диаграмму. Клик+shift – изменить выделение. Клик+alt – вставить фигуру и соединить.
signs=Знаки и пиктограммы
signOut=Выйти
simple=Простой
simpleArrow=Простая стрелка
size=Размер
solid=Сплошная
sourceSpacing=Отступ от начального узла
south=Юг
software=Программное обеспечение
space=Пространство
spacing=Интервал
specialLink=Специальная ссылка
standard=Стандарт
starting=Запуск
straight=Прямая
strokeColor=Цвет линии
style=Стиль
subscript=Нижний индекс
summary=Сводка
superscript=Верхний индекс
support=Поддержка
sysml=SysML
tags=Метки
table=Таблица
tables=Таблицы
takeOver=Take Over
targetSpacing=Отступ от конечного узла
template=Шаблон
templates=Шаблоны
text=Текст
textAlignment=Выравнивание текста
textOpacity=Непрозрачность текста
theme=Тема оформления
timeout=Время истекло
title=Название
to=по
toBack=На задний план
toFront=На передний план
tooltips=Подсказки
top=Сверху
topAlign=По верхнему краю
topLeft=Верхний левый
topRight=Верхний правый
transparent=Прозрачный
transparentBackground=Прозрачный фон
trello=Trello
tryAgain=Попробуйте еще раз
tryOpeningViaThisPage=Попробуйте открыть через эту страницу.
turn=Повернуть на 90 градусов
type=Тип
twitter=Twitter
uml=UML
underline=Подчеркнутый
undo=Отменить
ungroup=Разгруппировать
unsavedChanges=Изменения не сохранены
unsavedChangesClickHereToSave=Изменения не сохранены. Щелкните здесь для сохранения.
untitled=Без названия
untitledDiagram=Диаграмма без названия
untitledLayer=Слой без названия
untitledLibrary=Библиотека без названия
unknownError=Неизвестная ошибка
updateFile=Обновление {1}
updatingDocument=Документ обновляется. Пожалуйста, подождите...
updatingPreview=Подготовка предпросмотра. Пожалуйста, подождите...
updatingSelection=Обновление выделенной области. Пожалуйста, подождите...
upload=Загрузить
url=URL-адрес
useOffline=Use Offline
useRootFolder=Use root folder?
userManual=Инструкция
vertical=Вертикально
verticalFlow=Вертикальный поток
verticalTree=Вертикальное дерево
view=Вид
viewUrl=Ссылка для просмотра: {1}
voiceAssistant=Голосовой помошник (beta)
warning=Внимание
waypoints=Опорные точки
west=Запад
width=Ширина
wiki=Wiki
wordWrap=Перенос по словам
writingDirection=Направление текста
yes=да
yourEmailAddress=Ваш e-mail адрес
zoom=Масштаб
zoomIn=Увеличить
zoomOut=Уменьшить
basic=Базовые
businessprocess=Бизнес-процессы
charts=Графики
engineering=Инженерное дело
flowcharts=Блок-схемы
gmdl=Материальный дизайн
mindmaps=Майндмапы
mockups=Макеты
networkdiagrams=Сетевые диаграммы
nothingIsSelected=Ничего не выбрано
other=Другое
softwaredesign=Проектирование ПО
venndiagrams=Диаграммы Венна
webEmailOrOther=Адрес страницы, e-mail или иной интернет-адрес
webLink=Сетевая ссылка
wireframes=Макеты интерфейсов (UI)
