# *DO NOT DIRECTLY EDIT THIS FILE, IT IS AUTOMATICALLY GENERATED AND IT IS BASED ON:*
# https://docs.google.com/spreadsheet/ccc?key=0AmQEO36liL4FdDJLWVNMaVV2UmRKSnpXU09MYkdGbEE
aboutDrawio=Mengenai draw.io
accessDenied=Akses Ditolak
action=Action
actualSize=Saiz Sebenar
add=Tambah
addedFile=Tambah {1}
addImages=Tambah Imej
addImageUrl=Tambah URL Imej
addLayer=Tambah Lapisan
addProperty=Tambah Sifat
address=Alamat
addToExistingDrawing=Tambah ke Lukisan yang Sedia Ada
addWaypoint=Tambah Titik Arah
adjustTo=Ubah kepada
advanced=Lanjutan
align=Menjajar
alignment=Penjajaran
allChangesLost=Semua perubahan akan hilang!
allPages=Semua Halaman
allProjects=Semua Projek
allSpaces=Semua Ruang
allTags=Semua Tag
anchor=Sauh
android=Android
angle=Sudut
arc=Arc
areYouSure=Pastikah anda?
ensureDataSaved=Sila pastikan data anda telah disimpan sebelum menutup.
allChangesSaved=Semua perubahan telah disimpan
allChangesSavedInDrive=Semua perubahan telah disimpan dalam Drive
allowPopups=Benarkan pop-up untuk mengelak daripada dialog ini.
allowRelativeUrl=Allow relative URL
alreadyConnected=Nod telah disambungkan
apply=Gunakan
archiMate21=ArchiMate 2.1
arrange=Susun
arrow=Anak panah
arrows=Anak panah
asNew=Sebagai Baru
atlas=Atlas
author=Pengarang
authorizationRequired=Keizinan diperlukan
authorizeThisAppIn=Mengizinkan aplikasi ini di {1}:
authorize=Izinkan  
authorizing=Mengizinkan
automatic=Automatik
autosave=Simpan secara automatik
autosize=Mengubah saiz secara automatik
attachments=Lampiran
aws=AWS
aws3d=AWS 3D
azure=Azure
background=Latar belakang
backgroundColor=Warna Latar Belakang
backgroundImage=Imej Latar Belakang
basic=Asas
blankDrawing=Lukisan Kosong
blankDiagram=Gambarajah Kosong
block=Blok
blockquote=Blockquote
blog=Blog
bold=Cetak Tebal
bootstrap=Bootstrap
border=Border
borderColor=Warna Sempadan
borderWidth=Lebar sempadan
bottom=Bawah
bottomAlign=Jajaran Bawah
bottomLeft=Kiri Bawah
bottomRight=Kanan Bawah
bpmn=BPMN
browser=Pelayar
bulletedList=Senarai Berbulet
business=Perniagaan
busy=Operasi sedang berjalan
cabinets=Kabinet
cancel=Batal
center=Tengah
cannotLoad=Percubaan muatan gagal. Sila cuba semula sebentar lagi.
cannotLogin=Percubaan daftar masuk gagal. Sila cuba semula sebentar lagi.
cannotOpenFile=Tidak dapat membuka fail
change=Tukar
changeOrientation=Tukar Orientasi
changeUser=Tukar pengguna
changesNotSaved=Perubahan belum disimpan
chatJoined={1} telah menyertai
chatLeft={1} telah beredar
chatWindowTitle=Sembang
chooseAnOption=Pilih satu opsyen
chromeApp=Aplikasi Chrome
compressed=Mampat
commitMessage=Hantar Mesej
csv=CSV
dark=Dark
draftFound=Draf bagi '{1}' telah dijumpai. Muat ia ke dalam editor atau buang untuk meneruskan.
dragAndDropNotSupported=Seret dan lepas tidak disokong untuk imej. Adakah anda mahu mengimport?
dropboxCharsNotAllowed=Aksara-aksara berikut tidak dibenarkan: \ / : ? * " |
check=Semak
circle=Bulatan
cisco=Cisco
classic=Klasik
clearDefaultStyle=Kosongkan Gaya Lalai
clearWaypoints=Kosongkan Titik Arah
clipart=Seni klip
close=Tutup
collaborator=Kolaborator
collaborators=Kolaborator-kolaborator
collapse=Runtuhkan
collapseExpand=Runtuhkan/Kembangkan
collapse-expand=Klik untuk runtuhkan/kembangkan\nShift-klik untuk gerakkan jiran-jiran\nAlt-klik untuk melindungi saiz kumpulan
collapsible=Boleh diruntuhkan
comic=Komik
comment=Ulasan
commentsNotes=Ulasan-ulasan/Nota-nota
compress=Compress
connect=Menyambung
connecting=Sedang menyambung
connectWithDrive=Sambung dengan Google Drive
connection=Sambungan
connectionArrows=Anak Panah Sambungan
connectionPoints=Titik Sambungan
constrainProportions=Perkadaran Kekangan
containsValidationErrors=Mengandungi ralat-ralat pengesahan
copiedToClipboard=Disalin ke papan klip
copy=Salinan
copyConnect=Salinan semasa menyambung
copyOf=Salinan {1}
copyOfDrawing=Salinan Lukisan
copySize=Copy Size
copyStyle=Salin Gaya
create=Cipta
createNewDiagram=Cipta Gambarajah Baru
createRevision=Cipta Semakan
createShape=Cipta Bentuk
crop=Potong
curved=Melengkung
custom=Penyesuaian
current=Semasa
cut=Potong
dashed=Putus-putus
decideLater=Buat keputusan kemudian
default=Lalai
delete=Padam
deleteColumn=Padam Lajur
deleteLibrary401=Keizinan tidak mencukupi untuk memadam pustaka ini
deleteLibrary404=Pustaka yang dipilih tidak ditemui
deleteLibrary500=Ralat memadam pustaka
deleteLibraryConfirm=Anda akan memadam pustaka ini secara kekal. Adakah anda pasti anda mahu melakukan ini?
deleteRow=Padam Baris
description=Penerangan
device=Peranti
diagram=Gambarajah
diagramContent=Kandungan Gambarajah
diagramLocked=Gambarajah telah dikunci untuk mengelakkan lebih banyak kehilangan data.
diagramLockedBySince=The diagram is locked by {1} since {2} ago
diagramName=Nama Gambarajah
diagramIsPublic=Gambarajah umum
diagramIsNotPublic=Gambarajah tidak umum
diamond=Berlian
diamondThin=Berlian (nipis)
didYouKnow=Adakah anda tahu..
direction=Arah
discard=Batal
discardChangesAndReconnect=Batalkan Perubahan dan Sambung Semula
googleDriveMissingClickHere=Kehilangan Google Drive? Klik di sini!
discardChanges=Batalkan Perubahan
disconnected=Sambungan putus
distribute=Mengagih
done=Siap
dotted=Bertitik
doubleClickOrientation=Klik dua kali untuk mengubah orientasi
doubleClickTooltip=Klik dua kali untuk memasukkan teks
doubleClickChangeProperty=Klik dua kali untuk mengubah nama sifat
download=Muat turun
downloadDesktop=Download draw.io Desktop
downloadAs=Muat turun sebagai
clickHereToSave=Klik di sini untuk menyimpan.
draftDiscarded=Draf dibuang.
draftSaved=Draf disimpan.
dragElementsHere=Seret elemen ke sini
dragImagesHere=Seret imej atau URL ke sini
dragUrlsHere=Seret URL ke sini
draw.io=draw.io
drawing=Lukisan {1}
drawingEmpty=Lukisan kosong
drawingTooLarge=Lukisan terlalu besar
drawioForWork=Draw.io untuk GSuite
dropbox=Dropbox
duplicate=Menduakan
duplicateIt=Menduakan {1}
divider=Pembahagi
dx=Dx
dy=Dy
east=Timur
edit=Sunting
editData=Sunting Data
editDiagram=Sunting Gambarajah
editGeometry=Sunting Geometri
editImage=Sunting Imej
editImageUrl=Sunting URL Imej
editLink=Sunting Pautan
editShape=Sunting Bentuk
editStyle=Sunting Gaya
editText=Sunting Teks
editTooltip=Sunting Petua Alat
glass=Kaca
googleImages=Imej-imej Google
imageSearch=Carian Imej
eip=EIP
embed=Terbenam
embedImages=Imej Benam
mainEmbedNotice=Tampal ini pada halaman
electrical=Elektrik
ellipse=Ellipse
embedNotice=Tampal ini sekali di hujung muka surat
enterGroup=Masukkan Kumpulan
enterName=Masukkan Nama
enterPropertyName=Masukkan Nama Sifat
enterValue=Masukkan Nilai
entityRelation=Hubungan Entiti
error=Ralat
errorDeletingFile=Ralat Memadam Fail
errorLoadingFile=Ralat memuatkan fail
errorRenamingFile=Ralat menamakan semula fail.
errorRenamingFileNotFound=Ralat menamakan semula fail. Fail tidak ditemui.
errorRenamingFileForbidden=Ralat menamakan semula fail. Hak akses tidak mencukupi.
errorSavingDraft=Ralat menyimpan draf
errorSavingFile=Ralat menyimpan fail
errorSavingFileUnknown=Ralat mendapatkan kebenaran daripada pelayan Google. Sila segarkan semula halaman untuk mencuba lagi.
errorSavingFileForbidden=Ralat menyimpan fail. Hak akses tidak mencukupi.
errorSavingFileNameConflict=Tidak dapat menyimpan gambarajah. Halaman semasa sudah mengandungi fail bernama '{1}'.
errorSavingFileNotFound=Ralat menyimpan fail. Fail tidak ditemui.
errorSavingFileReadOnlyMode=Could not save diagram while read-only mode is active.
errorSavingFileSessionTimeout=Sesi anda telah tamat. Sila <a target='_blank' href='{1}'>{2}</a> dan kembali ke tab ini untuk mencuba menyimpan semula.
errorSendingFeedback=Ralat menghantar maklum balas.
errorUpdatingPreview=Ralat mengemaskini pratonton.
exit=Keluar  
exitGroup=Keluar dari Kumpulan
expand=Kembangkan 
export=Eksport  
exporting=Mengeksport
exportAs=Eksport sebagai
exportOptionsDisabled=Pilihan eksport dilumpuhkan
exportOptionsDisabledDetails=Pemilik telah melumpuhkan pilihan untuk memuat turun, mencetak atau menyalin untuk pengulas dan penonton pada fail ini.
extras=Tambahan
facebook=Facebook
failedToSaveTryReconnect=Gagal untuk menyimpan, cuba untuk menyambung semula
featureRequest=Permintaan Ciri
feedback=Maklum balas
feedbackSent=Maklum balas berjaya dihantar.
floorplans=Pelan lantai
file=Fail
fileChangedOverwrite=Fail telah diubah. Tulis ganti perubahan?
overwrite=Tulis ganti
filename=Nama fail
fileExists=Fail telah wujud
fileNearlyFullSeeFaq=Fail hampir penuh, sila lihat Soalan Lazim
fileNotFound=Fail tidak ditemui
repositoryNotFound=Repositori tidak ditemui
fileNotFoundOrDenied=Fail ini tidak ditemui. Ia tidak wujud atau anda tiada akses pembacaan.
fileNotLoaded=Fail tidak dimuatkan
fileNotSaved=Fail tidak disimpan
fileOpenLocation=Bagaimana anda mahu membuka fail-fail ini?
fileWillBeSavedInAppFolder={1} akan disimpan dalam folder aplikasi.
fill=Isi
fillColor=Isikan warna
filterCards=Filter Cards
find=Cari
fit=Muat
fitContainer=Ubah Saiz Kotak
fitIntoContainer=Muatkan ke dalam Kotak
fitPage=Muatkan Halaman
fitPageWidth=Muatkan Lebar Halaman
fitTo=Muatkan ke
fitToSheetsAcross=helaian ke seluruh
fitToBy=dan
fitToSheetsDown=helaian ke bawah
fitTwoPages=Dua Halaman
fitWindow=Muatkan Tetingkap
flip=Pusing
flipH=Pusing Melintang
flipV=Pusing Menegak
flowchart=Carta Aliran
folder=Folder
font=Font
fontColor=Warna Fon
fontFamily=Keluarga Fon
fontSize=Saiz Fon
forbidden=Anda tidak dibenarkan untuk mengakses fail ini
format=Format
formatPanel=Panel Format
formatted=Telah Diformat
formattedText=Teks yang telah Diformat
formatPng=PNG 
formatGif=GIF
formatJpg=JPEG
formatPdf=PDF
formatSql=SQL
formatSvg=SVG
formatHtmlEmbedded=HTML
formatSvgEmbedded=SVG (dengan XML)
formatVsdx=VSDX
formatVssx=VSSX
formatXmlPlain=XML (Ringkas)
formatXml=XML
forum=Perbincangan/Forum Bantuan
fromTemplate=Dari Templat
fromTemplateUrl=Dari URL Templat
fromText=Dari Teks
fromUrl=Dari URL
fromThisPage=Dari halaman ini
fullscreen=Skrin penuh
gap=Gap
gcp=GCP
general=Umum
github=GitHub
gliffy=Gliffy
global=Global
googleDocs=Google Docs
googleDrive=Google Drive
googleGadget=Peranti Google
googlePlus=Google+
googleSites=Google Sites
gradient=Kecerunan
gradientColor=Warna 
grid=Grid
gridColor=Warna Grid
gridSize=Saiz Grid
group=Kumpulan
guides=Panduan
hateApp=Saya tidak suka draw.io
heading=Tajuk
height=Ketinggian
help=Bantuan
helpTranslate=Bantu kami menterjemahkan aplikasi ini
hide=Sembunyikan  
hideIt=Sembunyikan {1}
hidden=Tersembunyi
home=Halaman utama
horizontal=Melintang
horizontalFlow=Aliran Melintang
horizontalTree=Pohon Melintang
howTranslate=Sebagus manakah terjemahan ini dalam bahasa anda?
html=HTML
htmlText=Teks HTML
id=ID
iframe=IFrame
ignore=Abaikan
image=Imej
imageUrl=URL Imej
images=Imej-imej
imagePreviewError=Imej ini tidak dapat dimuat untuk pratonton. Sila semak URL.
imageTooBig=Imej terlalu besar
imgur=Imgur
import=Import 
importFrom=Import dari
includeCopyOfMyDiagram=Masukkan satu salinan gambarajah saya
increaseIndent=Tambah Inden
decreaseIndent=Kurangkan Inden
insert=Masukkan
insertColumnBefore=Masukkan Lajur di Kiri
insertColumnAfter=Masukkan Lajur di Kanan
insertEllipse=Masukkan Elips
insertImage=Masukkan Imej
insertHorizontalRule=Masukkan Peraturan Melintang
insertLink=Masukkan Pautan
insertPage=Masukkan Halaman
insertRectangle=Masukkan Segi Empat
insertRhombus=Insert Rhombus
insertRowBefore=Masukkan Baris di Atas
insertRowAfter=Masukkan Baris Selepas
insertText=Masukkan Teks
inserting=Memasukkan
invalidFilename=Nama gambarajah tidak boleh mengandungi aksara yang berikut: \ / | : ; { } < > & + ? = "
invalidLicenseSeeThisPage=Lesen anda tidak sah, sila lihat ini <a target="_blank" href="https://support.draw.io/display/DFCS/Licensing+your+draw.io+plugin">page</a>.
invalidName=Nama tidak sah
invalidOrMissingFile=Fail tidak sah atau hilang
invalidPublicUrl=URL umum tidak sah
isometric=Isometrik
ios=iOS
italic=Italik
kennedy=Kennedy
keyboardShortcuts=Pintasan papan kekunci
layers=Lapisan
landscape=Landskap
language=Bahasa
leanMapping=LEAN Mapping
lastChange=Perubahan terakhir pada {1} yang lalu
lessThanAMinute=kurang dari satu minit
licensingError=Ralat Pelesenan
licenseHasExpired=Lesen untuk {1} telah luput pada {2}. Klik di sini.
licenseWillExpire=Lesen untuk {1} akan luput pada {2}. Klik di sini.
lineJumps=Line jumps
linkAccountRequired=Jika gambarajah tidak umum, akaun Google diperlukan untuk melihat pautan tersebut.
linkText=Teks Pautan
list=Senarai
minute=minit
minutes=minit
hours=jam
days=hari
months=bulan
years=tahun
restartForChangeRequired=Perubahan akan dapat dilihat selepas segar semula.
laneColor=Warna lorong
lastModified=Kali terakhir diubahsuai
layout=Susun atur
left=Kiri  
leftAlign=Jajaran kiri
leftToRight=Kiri ke kanan
libraryTooltip=Seret dan lepas bentuk di sini atau klik + untuk memasukkan. Klik dua kali untuk menyunting.
lightbox=Lightbox
line=Garis
lineend=Garis tamat
lineheight=Garis Tinggi
linestart=Garis mula
linewidth=Lebar garis
link=Pautan
links=Pautan
loading=Memuatkan
lockUnlock=Kunci/Buka kunci
loggedOut=Log Keluar
logIn=log masuk
loveIt=Saya suka {1}
lucidchart=Lucidchart
maps=Maps
mathematicalTypesetting=Atur Huruf Matematik
makeCopy=Buat satu Salinan
manual=Manual
middle=Tengah
minimal=Minimal
misc=Pelbagai
mockups=Latihan
modificationDate=Tarikh diubahsuai
modifiedBy=Diubahsuai oleh
more=Lagi
moreResults=Lebih Banyak Hasil
moreShapes=Lebih Banyak Bentuk
move=Pindah
moveToFolder=Pindahkan ke Folder
moving=Memindahkan
moveSelectionTo=Pindahkan pilihan ke {1}
name=Nama
navigation=Navigasi
network=Network
networking=Rangkaian
new=Baru
newLibrary=Pustaka Baru
nextPage=Halaman Seterusnya
no=Tidak
noAttachments=Tiada lampiran ditemui
noColor=Tiada Warna
noFiles=Tiada Fail
noFileSelected=Tiada fail dipilih
noLibraries=Tiada pustaka ditemui
noMoreResults=Tiada lagi hasil
none=Tiada
noOtherViewers=Tiada penonton lain
noPlugins=Tiada plugin
noPreview=Tiada pratonton
noResponse=Tiada respons daripada pelayan
noResultsFor=Tiada hasil untuk '{1}'
noRevisions=Tiada semakan
noSearchResults=Tiada hasil carian ditemui
noPageContentOrNotSaved=No anchors found on this page or it hasn't been saved yet
normal=Normal
north=Utara
notADiagramFile=Bukan fail gambarajah
notALibraryFile=Bukan fail pustaka
notAvailable=Tidak tersedia
notAUtf8File=Bukan fail UTF-8
notConnected=Tidak bersambung
note=Nota
notUsingService=Tidak menggunakan {1}?
numberedList=Senarai bernombor
offline=Luar talian
ok=OK
oneDrive=OneDrive
online=Dalam talian
opacity=Kelegapan
open=Buka
openArrow=Buka Anak Panah
openExistingDiagram=Buka Gambarajah Sedia Ada
openFile=Buka Fail
openFrom=Buka dari
openLibrary=Buka Pustaka
openLibraryFrom=Buka Pustaka dari
openLink=Buka Pautan
openInNewWindow=Buka dalam Tetingkap Baru
openInThisWindow=Buka dalam Tetingkap Ini
openIt=Buka {1}
openRecent=Buka Terbaru
openSupported=Format yang disokong adalah fail yang disimpan dari perisian ini (.xml), .vsdx dan .gliffy
options=Pilihan
organic=Organik
orthogonal=Ortogon
otherViewer=penonton lain
otherViewers=penonton-penonton lain
outline=Garis
oval=Bujur
page=Halaman
pageContent=Kandungan Halaman
pageNotFound=Halaman tidak ditemui
pageWithNumber=Halaman-{1}
pages=Halaman
pageView=Pandangan Halaman
pageSetup=Persediaan Halaman
pageScale=Skala Halaman
pan=Gerakkan
panTooltip=Jarak+Seret untuk menggerakkan objek
paperSize=Saiz Kertas
pattern=Corak
paste=Tampal
pasteHere=Tampal di sini
pasteSize=Paste Size
pasteStyle=Tampal Gaya
perimeter=Perimeter
permissionAnyone=Sesiapa boleh menyunting
permissionAuthor=Hanya saya boleh menyunting
pickFolder=Pilih folder
pickLibraryDialogTitle=Pilih Pustaka
publicDiagramUrl=URL umum gambarajah
placeholders=Pemegang tempat
plantUml=PlantUML
plugins=Plugin
pluginUrl=URL plugin
pluginWarning=Halaman ini telah diminta untuk memuatkan plugin yang berikut:\n\n {1}\n\n Adakah anda mahu memuatkan plugin ini sekarang?\n\n NOTA : Hanya benarkan plugin untuk dijalankan jika anda memahami sepenuhnya tentang implikasi keselamatan dengan berbuat demikian.\n
plusTooltip=Klik untuk menyambung dan mengklon (ctrl+klik untuk mengklon, shift+klik untuk menyambung). Seret untuk menyambung (ctrl+seret untuk mengklon).
portrait=Potret
position=Posisi
posterPrint=Cetakan Poster
preferences=Keutamaan
preview=Pratonton
previousPage=Halaman Sebelumnya
print=Cetak
printAllPages=Cetak Semua Halaman
procEng=Kejuruteraan Proses
project=Projek
priority=Sifat
properties=Sifat-sifat
publish=Terbit
quickStart=Mulakan Pantas Video
rack=Rak
radialTree=Pohon Radial
readOnly=Baca sahaja
reconnecting=Sambung semula
recentlyUpdated=Dikemaskini Baru-baru Ini
recentlyViewed=Dilihat Baru-baru Ini
rectangle=Rectangle
redirectToNewApp=Fail ini telah dicipta atau diubahsuai dalam versi terbaru aplikasi ini. Anda akan dilencongkan sekarang.
realtimeTimeout=Nampaknya anda telah membuat beberapa perubahan semasa di luar talian. Kami mohon maaf, perubahan ini tidak dapat disimpan.
redo=Buat semula
refresh=Segarkan semula
regularExpression=Regular Expression
relative=Relative
relativeUrlNotAllowed=Relative URL not allowed
rememberMe=Ingat saya
rememberThisSetting=Ingat tetapan ini
removeFormat=Kosongkan Format
removeFromGroup=Buang daripada Kumpulan
removeIt=Buang {1}
removeWaypoint=Buang Titik Arah
rename=Namakan semula
renamed=Telah dinamakan semula
renameIt=Namakan semula {1}
renaming=Sedang menamakan semula
replace=Ganti
replaceIt={1} telah wujud. Adakah anda mahu menggantikannya?
replaceExistingDrawing=Ganti lukisan yang sedia ada
required=diperlukan
reset=Tetapkan semula
resetView=Tetapkan semula Pandangan
resize=Ubah semula saiz
resizeLargeImages=Do you want to resize large images to make the application run faster?
retina=Retina
responsive=Responsif
restore=Pulihkan
restoring=Memulihkan
retryingIn=Cuba semula dalam {1} saat
retryingLoad=Gagal untuk memuatkan. Sedang mencuba semula...
retryingLogin=Masa log masuk tamat. Mencuba semula...
reverse=Undur
revision=Semak
revisionHistory=Sejarah Semakan
rhombus=Rhombus
right=Kanan
rightAlign=Jajaran Kanan
rightToLeft=Kanan ke kiri
rotate=Putar
rotateTooltip=Klik dan seret untuk memutar, klik untuk memutar sehingga 90 darjah
rotation=Putaran
rounded=Bulat
save=Simpan
saveAndExit=Simpan & Keluar
saveAs=Simpan sebagai
saveAsXmlFile=Simpan sebagai fail XML?
saved=Disimpan
saveDiagramsTo=Simpan gambarajah ke
saveLibrary403=Keizinan tidak mencukupi untuk menyunting pustaka ini
saveLibrary500=Terdapat ralat semasa menyimpan pustaka ini
saving=Menyimpan
scratchpad=Scratchpad
scrollbars=Baris gulung
search=Cari
searchShapes=Cari Bentuk
selectAll=Pilih Semua
selectionOnly=Pilihan Sahaja
selectCard=Select Card
selectEdges=Pilih Tepi
selectFile=Pilih Fail
selectFolder=Pilih Folder
selectFont=Pilih Fon
selectNone=Tidak Memilih
selectTemplate=Select Template
selectVertices=Pilih Bucu
sendMessage=Hantar
sendYourFeedbackToDrawIo=Hantar maklum balas anda ke draw.io
serviceUnavailableOrBlocked=Perkhidmatan tidak tersedia atau disekat
sessionExpired=Sesi anda telah tamat. Sila segarkan semula tetingkap pelayar.
sessionTimeoutOnSave=Sesi anda telah tamat dan anda telah terputus sambungan daripada Google Drive. Tekan OK untuk melog masuk dan menyimpan.
setAsDefaultStyle=Tetapkan sebagai Gaya Lalai
shadow=Bayang-bayang
shape=Bentuk
shapes=Bentuk-bentuk
share=Kongsi
shareLink=Pautan untuk suntingan kongsian
sharp=Tajam
show=Tunjuk
showStartScreen=Tunjuk Skrin Mula
sidebarTooltip=Klik untuk kembangkan. Seret dan lepas bentuk ke dalam gambarajah. Shift+klik untuk mengubah pilihan. Alt+klik untuk memasukkan dan menyambung.
signs=Tanda
signOut=Daftar keluar
simple=Ringkas
simpleArrow=Anak Panah Ringkas
size=Saiz
solid=Padat
sourceSpacing=Jarak Sumber
south=Selatan
software=Perisian
space=Ruang
spacing=Jarak
specialLink=Pautan Khas
standard=Standard
starting=Bermula
straight=Lurus
strokeColor=Warna Garis
style=Gaya
subscript=Subskrip
summary=Ringkasan
superscript=Superskrip
support=Sokongan
sysml=SysML
tags=Tag
table=Jadual
tables=Tables
takeOver=Take Over
targetSpacing=Jarak Sasaran
template=Templat
templates=Templat
text=Teks
textAlignment=Penjajaran Teks
textOpacity=Kelegapan Teks
theme=Tema
timeout=Masa tamat
title=Tajuk
to=ke
toBack=Ke Belakang
toFront=Ke Depan
tooltips=Petua-petua alat
top=Atas
topAlign=Jajaran Atas
topLeft=Kiri Atas
topRight=Kanan Atas
transparent=Lutsinar
transparentBackground=Latar Belakang Lutsinar
trello=Trello
tryAgain=Cuba lagi
tryOpeningViaThisPage=Cuba buka melalui halaman ini.
turn=Putar 90Â°
type=Jenis
twitter=Twitter
uml=UML
underline=Garis Bawah
undo=Buat Asal
ungroup=Asingkan Kumpulan
unsavedChanges=Perubahan tidak disimpan
unsavedChangesClickHereToSave=Perubahan tidak disimpan. Klik di sini untuk menyimpan.
untitled=Tanpa Tajuk
untitledDiagram=Gambarajah Tanpa Tajuk
untitledLayer=Lapisan Tanpa Tajuk
untitledLibrary=Pustaka Tanpa Tajuk
unknownError=Ralat tidak diketahui
updateFile=Kemaskini {1}
updatingDocument=Mengemaskini Dokumen. Sila tunggu...
updatingPreview=Mengemaskini Pratonton. Sila tunggu...
updatingSelection=Memuat naik pilihan. Sila tunggu...
upload=Muat naik
url=URL
useOffline=Use Offline
useRootFolder=Use root folder?
userManual=Manual Pengguna
vertical=Tegak
verticalFlow=Aliran Menegak
verticalTree=Pohon Menegak
view=Pandangan
viewUrl=Pautan untuk melihat: {1}
voiceAssistant=Pembantu Suara (beta)
warning=Amaran
waypoints=Titik-titik Arah
west=Barat
width=Lebar
wiki=Wiki
wordWrap=Balut Kata
writingDirection=Arah Tulisan
yes=Ya
yourEmailAddress=Alamat e-mel anda
zoom=Zum
zoomIn=Zum Masuk
zoomOut=Zum Keluar
basic=Asas
businessprocess=Proses Perniagaan
charts=Carta
engineering=Kejuruteraan
flowcharts=Carta aliran
gmdl=Reka Bentuk Bahan
mindmaps=Peta minda
mockups=Latihan
networkdiagrams=Gambarajah Rangkaian
nothingIsSelected=Tiada apa-apa dipilih
other=Lain-lain
softwaredesign=Reka Bentuk Perisian
venndiagrams=Gambarajah Venn
webEmailOrOther=Web, e-mel atau sebarang alamat internet lain
webLink=Pautan Web
wireframes=Rangka dawai
