# *DO NOT DIRECTLY EDIT THIS FILE, IT IS AUTOMATICALLY GENERATED AND IT IS BASED ON:*
# https://docs.google.com/spreadsheet/ccc?key=0AmQEO36liL4FdDJLWVNMaVV2UmRKSnpXU09MYkdGbEE
aboutDrawio=Sobre draw.io
accessDenied=Acesso Negado
action=Action
actualSize=Tamanho real 
add=Adicionar
addedFile=Adicionado {1}
addImages=Adicionar imagens
addImageUrl=Adicionar URL da imagem
addLayer=Adicionar camada
addProperty=Adicionar propriedade
address=Endereço
addToExistingDrawing=Adicionar ao desenho existente
addWaypoint=Adicionar ponto de notificação
adjustTo=Ajustar para 
advanced=Avançado
align=Alinhar 
alignment=Alinhamento
allChangesLost=Todas as alterações serão perdidas! 
allPages=Todas as páginas
allProjects=Todos os projectos
allSpaces=Todos os espaços
allTags=Todas as marcas
anchor=Âncora
android=Android
angle=Ângulo
arc=Arc
areYouSure=Tem a certeza?
ensureDataSaved=Por favor, assegure-se de guardar os seus dados antes de fechar.
allChangesSaved=Todas as alterações foram guardadas
allChangesSavedInDrive=Todas as alterações foram guardadas no Drive
allowPopups=Permita pop-ups para evitar o quadro de diálogo.
allowRelativeUrl=Allow relative URL
alreadyConnected=Nodos já conectados 
apply=Aplicar
archiMate21=ArchiMate 2.1
arrange=Ordenar
arrow=Setas
arrows=Setas
asNew=Como novo
atlas=Atlas
author=Autor
authorizationRequired=Autorização necessária
authorizeThisAppIn=Autorize esta aplicação em {1}:
authorize=Autorizar
authorizing=A autorizar
automatic=Automático
autosave=Guardar automáticamente
autosize=Dimensionar automaticamente
attachments=Anexos
aws=AWS
aws3d=AWS 3D
azure=Azure
background=Fundo
backgroundColor=Cor de fundo
backgroundImage=Imagem de plano de fundo
basic=Básico
blankDrawing=Desenho em branco
blankDiagram=Diagrama em branco
block=Bloco 
blockquote=Citação en bloco
blog=Blog
bold=Negrito 
bootstrap=Bootstrap
border=Border
borderColor=Cor da moldura
borderWidth=Largura da moldura
bottom=Fundo
bottomAlign=Alinhar ao fundo
bottomLeft=Inferior esquerdo
bottomRight=Inferior direito
bpmn=BPMN
browser=Navegador
bulletedList=Lista com marcas
business=Negócio
busy=Operação em curso
cabinets=Armários
cancel=Cancelar 
center=Centrar
cannotLoad=Ocorreu um erro ao tentar carregar. Por favor, tente novamente.
cannotLogin=Ocorreu um erro ao iniciar sessão. Por favor, tente novamente.
cannotOpenFile=Não é possível abrir o ficheiro
change=Alterar
changeOrientation=Alterar orientação
changeUser=Alterar o usuário
changesNotSaved=As alterações não foram guardadas
chatJoined={1} juntou-se
chatLeft={1} saiu
chatWindowTitle=Conversa
chooseAnOption=Escolha uma opção
chromeApp=Chrome App
compressed=Compactado
commitMessage=Mensagem da alteração
csv=CSV
dark=Dark
draftFound=Encontrado um projeto. Carregar no editor ou rejeitar para continuar.
dragAndDropNotSupported=Arrastar e largar não suportado para imagens. Deseja importar?
dropboxCharsNotAllowed=Os seguintes caracteres não são permitidos: \/:?*"|
check=Verificar
circle=Círculo
cisco=Cisco
classic=Clássico
clearDefaultStyle=Limpar estilo predefinido
clearWaypoints=Limpar pontos de notificação
clipart=Clipart
close=Fechar 
collaborator=Colaborador
collaborators=Colaboradores
collapse=Recolher
collapseExpand=Reduzir/Ampliar
collapse-expand=Carregar para reduzir/ampliar\ Carregar Shift para mover os vizinhos n\Carregar Alt para proteger o tamanho do grupo
collapsible=Reduzível
comic=Cómico
comment=Comentário
commentsNotes=Comentários/Notas
compress=Compress
connect=Conetar
connecting=A conetar
connectWithDrive=Conete-se com Google Drive
connection=Conexão 
connectionArrows=Setas de conexão
connectionPoints=Pontos de conexão
constrainProportions=Restringir proporções
containsValidationErrors=Contém erros de validação 
copiedToClipboard=Copiado para área de transferência
copy=Copiar
copyConnect=Copiar ao conetar
copyOf=Cópia do {1}
copyOfDrawing=Cópia do desenho
copySize=Copy Size
copyStyle=Copiar estilo
create=Criar
createNewDiagram=Criar diagrama novo
createRevision=Criar revisão
createShape=Criar forma
crop=Recortar
curved=Curvado
custom=Personalizado
current=Atual
cut=Cortar 
dashed=Tracejado 
decideLater=Decidir mais tarde
default=Predefinido
delete=Excluir
deleteColumn=Excluir coluna
deleteLibrary401=Permissões insuficientes para suprimir esta biblioteca
deleteLibrary404=Biblioteca seleccionada não foi encontrada
deleteLibrary500=Erro ao apagar a biblioteca
deleteLibraryConfirm=Estás prestes a apagar esta biblioteca. Tens a certeza?
deleteRow=Excluir linha
description=Descrição
device=Aparelho
diagram=Diagrama
diagramContent=Conteúdo do diagrama
diagramLocked=O diagrama foi bloqueado para a prevenção de perda de dados 
diagramLockedBySince=The diagram is locked by {1} since {2} ago
diagramName=Nome do diagrama
diagramIsPublic=Diagrama é público
diagramIsNotPublic=Diagrama não é público
diamond=Diamante
diamondThin=Diamante (fino)
didYouKnow=Sabias que...
direction=Direção 
discard=Rejeitar
discardChangesAndReconnect=Rejeitar mudanças e reconectar
googleDriveMissingClickHere=Google Drive ausente?
discardChanges=Rejeitar mudanças
disconnected=Desconetado
distribute=Distribuir
done=Concluído
dotted=Pontilhado
doubleClickOrientation=Carregar duas vezes para mudar de orientação 
doubleClickTooltip=Carregar duas vezes para inserir texto
doubleClickChangeProperty=Carregar duas vezes para alterar o nome da propriedade
download=Descarregar
downloadDesktop=Download draw.io Desktop
downloadAs=Descarregar como
clickHereToSave=Carregar aqui para salvar.
draftDiscarded=Projeto descartado.
draftSaved=Projeto salvo
dragElementsHere=Arraste elementos aqui
dragImagesHere=Arraste as imagens ou os URLs aqui
dragUrlsHere=Arraste os URLs aqui
draw.io=draw.io
drawing=Desenho{1}
drawingEmpty=O desenho está vazio
drawingTooLarge=O desenho é demasiado grande 
drawioForWork=Draw.io para GSuite
dropbox=Dropbox
duplicate=Duplicar
duplicateIt=Duplicar {1]
divider=Separador
dx=Dx
dy=Dy
east=Leste
edit=Editar 
editData=Editar os dados
editDiagram=Editar o diagrama
editGeometry=Editar geometria
editImage=Editar imagem
editImageUrl=Editar URL da imagem
editLink=Editar ligação
editShape=Editar formato
editStyle=Editar estilo
editText=Editar texto
editTooltip=Editar dicas de ferramenta
glass=Vidro
googleImages=Google Imagens
imageSearch=Procurar imagem
eip=EIP
embed=Inserir
embedImages=Inserir imagens
mainEmbedNotice=Colá-lo na página
electrical=Eléctrico
ellipse=Ellipse
embedNotice=Adicioná-lo uma vez, no fim da página
enterGroup=Inserir grupo
enterName=Inserir nome
enterPropertyName=Inserir nome de propriedade
enterValue=Inserir o valor 
entityRelation=Relação de entidade
error=Erro 
errorDeletingFile=Erro ao apagar o ficheiro
errorLoadingFile=Erro ao carregar o ficheiro
errorRenamingFile=Erro ao renomear o ficheiro.
errorRenamingFileNotFound=Erro ao renomear o ficheiro. Ficheiro não encontrado.
errorRenamingFileForbidden=Erro ao renomear o ficheiro. Direitos de acesso insuficientes.
errorSavingDraft=Erro ao salvar o projeto
errorSavingFile=Erro ao guardar o ficheiro.
errorSavingFileUnknown=Erro ao autorizar com os servidores do Google. Por favor, atualize a página para tentar novamente.
errorSavingFileForbidden=Erro ao guardar o ficheiro. Direitos de acesso insuficientes.
errorSavingFileNameConflict=Não foi possível salvar o diagrama. A página atual já contem ficheiro com nome '{1}'.
errorSavingFileNotFound=Erro ao guardar o ficheiro. Ficheiro não encontrado.
errorSavingFileReadOnlyMode=Could not save diagram while read-only mode is active.
errorSavingFileSessionTimeout=Sua sessão foi terminada. Por favor <a target='_blank' href='{1}'>{2}</a> e retorne a esta guia para tentar salvar novamente.
errorSendingFeedback=Erro ao enviar feedback.
errorUpdatingPreview=Erro actualização antevisão.
exit=Sair
exitGroup=Sair do Grupo
expand=Expandir
export=Exportar
exporting=Exportando
exportAs=Exportar como
exportOptionsDisabled=Exportar opções desactivadas
exportOptionsDisabledDetails=O proprietário desactivou as opções de descarga, impressão ou cópia para comentadores e visuaizados neste ficheiro.
extras=Extras
facebook=Facebook
failedToSaveTryReconnect=Falha ao salvar, tentando reconetar
featureRequest=Solicitar recurso
feedback=Feedback
feedbackSent=Feedback enviado com sucesso.
floorplans=Plantas
file=Ficheiro
fileChangedOverwrite=Ficheiro foi modificado. Sobrepor modificações?
overwrite=Sobrepor
filename=Nome do ficheiro
fileExists=Ficheiro já existente
fileNearlyFullSeeFaq=Ficheiro quase cheio, por favor veja FAQ
fileNotFound=Ficheiro não encontrado
repositoryNotFound=Repositório não encontrado
fileNotFoundOrDenied=O ficheiro não foi encontrado. Não existe ou não tem acesso à leitura. 
fileNotLoaded=Ficheiro não carregado
fileNotSaved=Ficheiro não guardado
fileOpenLocation=Como gostava de abrir o(s) ficheiro(s)?
fileWillBeSavedInAppFolder={1} será guardado na pasta de aplicações.
fill=Preencher
fillColor=Cor de preenchimento 
filterCards=Filter Cards
find=Encontrar
fit=Ajustar
fitContainer=Redimensionar contentor
fitIntoContainer=Ajustar no contentor
fitPage=Ajustar página
fitPageWidth=Ajustar largura da página
fitTo=Ajustar para
fitToSheetsAcross=Toda a(s) folha(s)
fitToBy=Por
fitToSheetsDown=Página(s) para baixo
fitTwoPages=Duas páginas
fitWindow=Ajustar janela 
flip=Inverter
flipH=Inverter horizontalmente
flipV=Inverter vertical
flowchart=Diagrama
folder=Pasta
font=Fonte
fontColor=Cor da fonte 
fontFamily=Família da fonte
fontSize=Tamanho da fonte
forbidden=Não está autorizado a aceder a este ficheiro.
format=Formatar
formatPanel=Painel de formato
formatted=Formatado
formattedText=Texto formatado
formatPng=PNG
formatGif=GIF
formatJpg=JPEG
formatPdf=PDF
formatSql=SQL
formatSvg=SVG
formatHtmlEmbedded=HTML
formatSvgEmbedded=SVG (com XML)
formatVsdx=VSDX
formatVssx=VSSX
formatXmlPlain=XML (simples)
formatXml=XML
forum=Fóruns de discussão e ajuda
fromTemplate=Do modelo
fromTemplateUrl=Do modelo de URL
fromText=Do texto
fromUrl=Da URL
fromThisPage=Desta página
fullscreen=Ecrã completo
gap=Gap
gcp=GCP
general=Geral
github=GitHub
gliffy=Gliffy
global=Global 
googleDocs=Google Docs
googleDrive=Google Drive
googleGadget=Google Gadget
googlePlus=Google+
googleSites=Google Sites
gradient=Gradiente
gradientColor=Cor
grid=Grelha
gridColor=Cor da grelha
gridSize=Tamanho da grelha
group=Agrupar
guides=Guias
hateApp=Eu odeio draw.io
heading=Cabeçalho
height=Altura 
help=Ajuda 
helpTranslate=Ajude-nos a traduzir esta aplicação
hide=Ocultar 
hideIt=Ocultar {1}
hidden=Oculto
home=Página inicial
horizontal=Horizontal 
horizontalFlow=Fluxo horizontal
horizontalTree=Árvore horizontal
howTranslate=Como está a tradução?
html=HTML
htmlText=Texto HTML
id=ID
iframe=IFrame
ignore=Ignorar
image=Imagem
imageUrl=Imagem URL
images=Imagens
imagePreviewError=Esta imagem não pode ser carregada para antevisão. Por favor verificar a URL
imageTooBig=Imagem é demasiado grande
imgur=Imgur
import=Importar
importFrom=Importar de
includeCopyOfMyDiagram=Incluir uma cópia do meu diagrama
increaseIndent=Aumentar avanço de parágrafo
decreaseIndent=Diminuir avanço de parágrafo
insert=Inserir
insertColumnBefore=Inserir coluna à esquerda
insertColumnAfter=Inserir coluna à direita
insertEllipse=Inserir elipse
insertImage=Inserir imagem
insertHorizontalRule=Inserir linha horizontal
insertLink=Inserir link
insertPage=Inserir página
insertRectangle=Inserir retângulo
insertRhombus=Insert Rhombus
insertRowBefore=Inserir linha acima
insertRowAfter=Inserir linha abaixo
insertText=Inserir texto
inserting=A inserir
invalidFilename=Nomes de diagramas não podem conter os seguintes caracteres:\ / | : ; { } < > & + ? = "
invalidLicenseSeeThisPage=A sua carta não é válida, por favor veja <a target="_blank" href="https://support.draw.io/display/DFCS/Licensing+your+draw.io+plugin">page</a>.
invalidName=Nome inválido
invalidOrMissingFile=Ficheiro inválido ou em falta
invalidPublicUrl=URL pública inválida
isometric=Isométrico
ios=iOS
italic=Itálico 
kennedy=Kennedy
keyboardShortcuts=Atalhos do teclado
layers=Camadas
landscape=Horizontal 
language=Linguagem
leanMapping=Mapeamento
lastChange=A última alteração foi realizada {1} atrás
lessThanAMinute=menos de um minuto
licensingError=Erro de licença
licenseHasExpired=A licença para {1} expirou em {2}. Carregar aqui.
licenseWillExpire=A licença para {1} expira em {2}. Carregar aqui.
lineJumps=Line jumps
linkAccountRequired=Se o diagrama não é público é necessário ter uma conta no Google para ver o link.
linkText=Texto do link
list=Lista
minute=minuto
minutes=minutos
hours=horas
days=dias
months=meses
years=anos
restartForChangeRequired=As alterações serão visualizadas depois de atualizar a página.
laneColor=Cartela de cores
lastModified=Última redacção
layout=Traçado
left=Esquerda 
leftAlign=Alinhar à esquerda 
leftToRight=De esquerda à direita
libraryTooltip=Arrastar e largar os formatos aqui ou carregar + para inserir. Carregar duas vezes para editar.
lightbox=Lightbox
line=Linha 
lineend=Fim da linha
lineheight=Altura da Linha
linestart=Início da linha
linewidth=Largura da linha
link=Link
links=Links
loading=A carregar
lockUnlock=Bloquear/Desbloquear
loggedOut=Desconetado
logIn=Conetar
loveIt=Eu adoro {1}
lucidchart=Lucidchart
maps=Maps
mathematicalTypesetting=Composição tipográfica matemática
makeCopy=Fazer uma cópia
manual=Manual
middle=Meio
minimal=Minimal
misc=Diversos
mockups=Maquetas
modificationDate=Data de modificação
modifiedBy=Modificado pelo
more=Mais
moreResults=Mais resultados
moreShapes=Mais formas
move=Mover
moveToFolder=Mover para a pasta
moving=A mover
moveSelectionTo=Mover seleção para {1}
name=Nome
navigation=Navegação
network=Network
networking=Ligação em rede
new=Novo 
newLibrary=Nova biblioteca
nextPage=Página seguinte
no=Não
noAttachments=Nenhum anexo encontrado
noColor=Sem cor
noFiles=Nenhum ficheiro
noFileSelected=Nenhum ficheiro selecionado
noLibraries=Nenhuma biblioteca encontrada
noMoreResults=Sem mais resultados
none=Nada
noOtherViewers=Nenhum outro usuário
noPlugins=Não há nenhum plugin
noPreview=Nenhuma antevisão
noResponse=Sem resposta do servidor
noResultsFor=Sem resultados para '{1}'
noRevisions=Nenhuma revisão
noSearchResults=Nenhum resultado de pesquisa encontrado
noPageContentOrNotSaved=Nenhuma âncora encontrada nesta página ou ainda não foi gravada
normal=Normal
north=Norte 
notADiagramFile=Não é um ficheiro de diagrama
notALibraryFile=Não é um ficheiro de biblioteca
notAvailable=Não está disponível
notAUtf8File=Não é um ficheiro UTF-8
notConnected=Não conetado
note=Nota
notUsingService=Não está a utilizar {1}?
numberedList=Lista numerada
offline=Desconetado
ok=OK 
oneDrive=OneDrive
online=Conetado
opacity=Opacidade 
open=Abrir 
openArrow=Abrir seta
openExistingDiagram=Abrir diagrama existente
openFile=Abrir ficheiro
openFrom=Abrir de
openLibrary=Abrir biblioteca
openLibraryFrom=Abrir biblioteca de
openLink=Abrir link
openInNewWindow=Abrir em outra janela
openInThisWindow=Abrir na janela atual
openIt=Abrir {1}
openRecent=Abrir Recente
openSupported=Os formatos suportados são os ficheiros guardados deste software (.xml), .vsdx e .gliffy
options=Opções
organic=Orgânico
orthogonal=Ortogonal
otherViewer=outro usuário
otherViewers=outros usuários
outline=Contorno
oval=Oval 
page=Página
pageContent=Conteúdo da Página
pageNotFound=Página nõ encontrada
pageWithNumber=Página-{1}
pages=Páginas
pageView=Layout da página 
pageSetup=Configuração da página
pageScale=Escala da página
pan=Panorama
panTooltip=Espaço+Arrastar para deslocar 
paperSize=Tamanho do papel 
pattern=Padrão
paste=Colar 
pasteHere=Colar aqui
pasteSize=Paste Size
pasteStyle=Colar estilo
perimeter=Perímetro 
permissionAnyone=Qualquer um pode editar
permissionAuthor=Somente eu posso editar
pickFolder=Escolha uma pasta
pickLibraryDialogTitle=Seleccione biblioteca
publicDiagramUrl=URL pública do diagrama
placeholders=Substituições
plantUml=PlantaUML
plugins=Extensões
pluginUrl=URL da extensão
pluginWarning=A página solicitou o carregamento do(s) seguinte(s) plugin(s):\n \n {1}\n \n Gostava de carregar o(os) plugin(s) agora?\n \n NOTA: Apenas permita executar os plugins se entende completamente as implicações de segurança implicadas.\n
plusTooltip=Clique e arraste para conetar; clique para clonar e conetar; clique no shift para clonar
portrait=Vertical
position=Posição 
posterPrint=Imprimir cartaz 
preferences=Preferências
preview=Pré-visualizar 
previousPage=Página anterior
print=Imprimir 
printAllPages=Imprimir todas as páginas
procEng=Engenharia de Processos
project=Projecto
priority=Prioridade
properties=Propriedades
publish=Publicar
quickStart=Início rápido vídeo
rack=Prateleira
radialTree=Árvore radial
readOnly=Somente de leitura
reconnecting=A reconetar
recentlyUpdated=Recentemente actualizado
recentlyViewed=Recentemente visto
rectangle=Rectangle
redirectToNewApp=Este ficheiro foi criado ou modificado em draw.io pro. Serás redireccionado.
realtimeTimeout=Parece que realizou algumas alterações enquanto estava desconetado. Lamentamos, mas estas alterações não podem ser guardadas.
redo=Refazer 
refresh=Atualizar
regularExpression=Expressão regular
relative=Relative
relativeUrlNotAllowed=Relative URL not allowed
rememberMe=Lembre-se de mim
rememberThisSetting=Lembre-se desta configuração
removeFormat=Limpar formatação
removeFromGroup=Remover do grupo 
removeIt=Remover {1}
removeWaypoint=Remover ponto de notificação
rename=Renomear
renamed=Renomeado
renameIt=Renomear {1}
renaming=A renomear
replace=Substituir
replaceIt={1} já existe. Deseja substituí-lo? 
replaceExistingDrawing=Substituir desenho já existente
required=obrigatório
reset=Reiniciallizar
resetView=Repor a visualização
resize=Redimensionar
resizeLargeImages=Do you want to resize large images to make the application run faster?
retina=Retina
responsive=Responsivo
restore=Restaurar
restoring=A restaurar
retryingIn=A tentar novamente em {1} segundo(s)
retryingLoad=Erro no carregamento. A tentar novamente...
retryingLogin=Tempo de inicio da sessão esgotado. A tentar novamente...
reverse=Reverter
revision=Revisão
revisionHistory=Histórico de revisões
rhombus=Rhombus
right=Direita 
rightAlign=Alinhar à direita 
rightToLeft=Direita para esquerda
rotate=Rodar
rotateTooltip=Carregue e arraste para rodar, carregue para virar 90 graus
rotation=Rotação 
rounded=Arredondado 
save=Guardar
saveAndExit=Guardar e sair
saveAs=Guardar como
saveAsXmlFile=Guardar como ficheiro XML?
saved=Guardado
saveDiagramsTo=Guardar os diagramas em
saveLibrary403=Permissões não suficientes para editar esta biblioteca.
saveLibrary500=Ocorreu um erro ao gravar a biblioteca
saving=A guardar 
scratchpad=Rascunho
scrollbars=Barras de rolagem
search=Pesquisar
searchShapes=Procurar formatos
selectAll=Seleccionar tudo 
selectionOnly=Seleccionar somente
selectCard=Select Card
selectEdges=Seleccionar margens
selectFile=Seleccionar Ficheiro
selectFolder=Seleccionar Pasta
selectFont=Seleccionar uma fonte 
selectNone=Seleccione nenhum
selectTemplate=Select Template
selectVertices=Seleccionar vértices 
sendMessage=Enviar
sendYourFeedbackToDrawIo=Enviar o seu feedback para draw.io
serviceUnavailableOrBlocked=Serviço indisponível ou bloqueado
sessionExpired=A sua sessão expirou. Por favor, actualizar a janela do navegador.
sessionTimeoutOnSave=O tempo de sua sessão esgotou e foi desconetado do Google Drive. Pressione OK para iniciar a sessão e guardar.
setAsDefaultStyle=Configurar como estilo predefinido
shadow=Sombra
shape=Forma 
shapes=Formas
share=Partilhar
shareLink=Link para a edição partilhada
sharp=Quadrado
show=Mostrar
showStartScreen=Mostrar Tela de Começo
sidebarTooltip=Carregar para alargar. Arrastar e largar os formatos dentro do diagrama. Shift+carregar para alterar a seleção. Alt+carregar para inserir e conetar.
signs=Sinais
signOut=Sair
simple=Simples
simpleArrow=Seta simples
size=Tamanho 
solid=Sólido
sourceSpacing=Espaçamento entre fontes
south=Sul
software=Software
space=Espaço
spacing=Espaçamento 
specialLink=Link especial
standard=Padrão
starting=A iniciar
straight=Reto
strokeColor=Cor da linha 
style=Estilo 
subscript=Subescrever
summary=Resumo
superscript=Sobrescrever
support=Ajuda
sysml=SysML
tags=Marcadores
table=Tabela
tables=Tables
takeOver=Take Over
targetSpacing=Espaçamento do objetivo
template=Modelo
templates=Modelos
text=Texto
textAlignment=Alinhamento do texto 
textOpacity=Opacidade do texto
theme=Tema
timeout=Tempo esgotado
title=Título
to=Para
toBack=Para trás 
toFront=Para a frente 
tooltips=Dicas de ferramenta
top=Topo
topAlign=Alinhar ao topo
topLeft=Superior Esquerdo
topRight=Superior Direito
transparent=Transparente
transparentBackground=Fundo Transparente
trello=Trello
tryAgain=Tentar novamente
tryOpeningViaThisPage=Tentar abrir através desta página
turn=Virar 90°
type=Tipo
twitter=Twitter
uml=UML
underline=Sublinhar
undo=Desfazer 
ungroup=Desagrupar 
unsavedChanges=Alterações não guardadas
unsavedChangesClickHereToSave=Alterações não guardadas. Carregar aqui para guardar.
untitled=Sem nome
untitledDiagram=Diagrama sem nome
untitledLayer=Camada sem nome
untitledLibrary=Biblioteca sem nome
unknownError=Erro desconhecido
updateFile=Actualizar {1}
updatingDocument=A atualizar o documento. Por favor, aguarde... 
updatingPreview=A atualizar a antevisão. Por favor, aguarde...
updatingSelection=A atualizar a seleção. Por favor, aguarde... 
upload=Carregar
url=URL
useOffline=Use Offline
useRootFolder=Use root folder?
userManual=Manual do Utilizador
vertical=Vertical 
verticalFlow=Fluxo vertical
verticalTree=Árvore vertical
view=Visualização
viewUrl=Link para visualização: {1}
voiceAssistant=Assistente de Voz (beta)
warning=Aviso
waypoints=Pontos de notificação
west=Oeste
width=Largura 
wiki=Wiki
wordWrap=Quebra de linha
writingDirection=Direção da escrita
yes=Sim
yourEmailAddress=O teu endereço electrónico
zoom=Zoom 
zoomIn=Mais zoom 
zoomOut=Menos zoom 
basic=Básico
businessprocess=Processos de negócios
charts=Gráficos
engineering=Engenharia
flowcharts=Fluxograma
gmdl=Concepção de material
mindmaps=Mapas da mente
mockups=Maquetes
networkdiagrams=Rede de diagramas
nothingIsSelected=Nenhuma seleção
other=Outros
softwaredesign=Design de software
venndiagrams=Diagramas de Venn
webEmailOrOther=Web, endereço electrónico ou outro endereço da internet
webLink=Link da Web
wireframes=Wireframes
