# *DO NOT DIRECTLY EDIT THIS FILE, IT IS AUTOMATICALLY GENERATED AND IT IS BASED ON:*
# https://docs.google.com/spreadsheet/ccc?key=0AmQEO36liL4FdDJLWVNMaVV2UmRKSnpXU09MYkdGbEE
aboutDrawio=Over draw.io
accessDenied=Toegang geweigerd
action=Action
actualSize=Ware grootte
add=Toevoegen
addedFile={1} toegevoegd
addImages=Afbeeldingen toevoegen
addImageUrl=Afbeelding-URL toevoegen
addLayer=Laag toevoegen
addProperty=Eigenschap toevoegen
address=Adres
addToExistingDrawing=Aan bestaande tekening toevoegen
addWaypoint=Tussenpunt toevoegen
adjustTo=Aanpassen aan
advanced=Geavanceerd
align=Uitlijnen
alignment=Uitlijning
allChangesLost=Alle wijzigingen zullen verloren gaan!
allPages=Alle pagina's
allProjects=Alle projecten
allSpaces=Alle ruimtes
allTags=Alle tags
anchor=Anker
android=Android
angle=Hoek
arc=Boog
areYouSure=Weet u het zeker?
ensureDataSaved=Zorg dat uw gegevens zijn opgeslagen alvorens af te sluiten.
allChangesSaved=Alle wijzigingen opgeslagen
allChangesSavedInDrive=Alle wijzigingen in Drive opgeslagen
allowPopups=Pop-ups toestaan om deze dialoog te vermijden.
allowRelativeUrl=Relatieve URL toestaan
alreadyConnected=Knooppunten reeds verbonden
apply=Toepassen
archiMate21=ArchiMate 2.1
arrange=Ordenen
arrow=Pijl
arrows=Pijlen
asNew=Als nieuw
atlas=Atlas
author=Auteur
authorizationRequired=Autorisatie vereist
authorizeThisAppIn=Autoriseer deze app in {1}:
authorize=Autoriseren
authorizing=Autoriseren
automatic=Automatisch
autosave=Automatisch opslaan
autosize=Automatisch grootte bepalen
attachments=Bijlagen
aws=AWS
aws3d=AWS 3D
azure=Azure
background=Achtergrond
backgroundColor=Achtergrondkleur
backgroundImage=Achtergrondafbeelding
basic=Eenvoudig
blankDrawing=Lege tekening
blankDiagram=Leeg diagram
block=Blok
blockquote=Citaat
blog=Blog
bold=Vet
bootstrap=Bootstrap
border=Rand
borderColor=Randkleur
borderWidth=Randbreedte
bottom=Onder
bottomAlign=Onder uitlijnen
bottomLeft=Linksonder
bottomRight=Rechtsonder
bpmn=BPMN
browser=Browser
bulletedList=Lijst met opsommingstekens
business=Zakelijk
busy=Bewerking in uitvoering
cabinets=Kasten
cancel=Annuleren
center=Centreren
cannotLoad=Pogingen tot laden mislukt. Probeer het later nog eens.
cannotLogin=Pogingen tot inloggen mislukt. Probeer het later nog eens.
cannotOpenFile=Kan bestand niet openen
change=Wijzigen
changeOrientation=Oriëntatie wijzigen
changeUser=Gebruiker wijzigen
changesNotSaved=Wijzigingen niet opgeslagen
chatJoined={1} heeft zich aangesloten
chatLeft={1} is vertrokken
chatWindowTitle=Chat
chooseAnOption=Kies een optie
chromeApp=Chrome App
compressed=Gecomprimeerd
commitMessage=Bericht vastleggen
csv=CSV
dark=Donker
draftFound=Een concept van '{1}' is gevonden. Laad het in de editor of negeer het om door te gaan.
dragAndDropNotSupported=Slepen en plaatsen is niet beschikbaar voor afbeeldingen. Wilt u in plaats daarvan importeren?
dropboxCharsNotAllowed=De volgende tekens zijn niet toegestaan: \ / : ? * " |
check=Controleren
circle=Cirkel
cisco=Cisco
classic=Klassiek
clearDefaultStyle=Standaardstijl wissen
clearWaypoints=Tussenpunten wissen
clipart=Clipart
close=Sluiten
collaborator=Medewerker
collaborators=Medewerkers
collapse=Inklappen
collapseExpand=Inklappen/uitklappen
collapse-expand=Klik om in te klappen/uit te klappen\nShift-klik om buren te verplaatsen\nAlt-klik om groepsgrootte te beschermen
collapsible=Inklapbaar
comic=Rafelig
comment=Commentaar
commentsNotes=Commentaren/Opmerkingen
compress=Compress
connect=Verbinden
connecting=Verbinding maken
connectWithDrive=Verbinden met Google Drive
connection=Verbinding
connectionArrows=Verbindingspijlen
connectionPoints=Verbindingspunten
constrainProportions=Verhoudingen beperken
containsValidationErrors=Bevat validatiefouten
copiedToClipboard=Gekopieerd naar klembord
copy=Kopiëren
copyConnect=Kopiëren bij verbinding
copyOf=Kopie van {1}
copyOfDrawing=Kopie van tekening
copySize=Copy Size
copyStyle=Stijl kopiëren
create=Aanmaken
createNewDiagram=Nieuw diagram aanmaken
createRevision=Revisie aanmaken
createShape=Vorm aanmaken
crop=Bijsnijden
curved=Gewelfd
custom=Aangepast
current=Huidig
cut=Knippen
dashed=Gestreept
decideLater=Later beslissen
default=Standaard
delete=Verwijderen
deleteColumn=Kolom verwijderen
deleteLibrary401=Onvoldoende rechten om deze bibliotheek te verwijderen
deleteLibrary404=Geselecteerde bibliotheek kon niet worden gevonden
deleteLibrary500=Fout bij verwijderen bibliotheek
deleteLibraryConfirm=U staat op het punt deze bibliotheek permanent te verwijderen. Weet u zeker dat u dit wilt doen?
deleteRow=Rij verwijderen
description=Beschrijving
device=Apparaat
diagram=Diagram
diagramContent=Inhoud diagram
diagramLocked=Diagram is vergrendeld om verder gegevensverlies te voorkomen.
diagramLockedBySince=Het diagram is sinds {2} door {1} geblokkeerd
diagramName=Diagramnaam
diagramIsPublic=Diagram is openbaar
diagramIsNotPublic=Diagram is niet openbaar
diamond=Ruit
diamondThin=Ruit (dun)
didYouKnow=Wist u dat...
direction=Richting
discard=Negeren
discardChangesAndReconnect=Wijzigingen negeren en opnieuw verbinden
googleDriveMissingClickHere=Ontbreekt Google Drive? Klik hier!
discardChanges=Wijzigingen negeren
disconnected=Verbinding verbroken
distribute=Distribueren
done=Klaar
dotted=Gestippeld
doubleClickOrientation=Dubbelklik om oriëntatie te wijzigen
doubleClickTooltip=Dubbelklik om tekst in te voegen
doubleClickChangeProperty=Dubbelklik om eigenschapsnaam te wijzigen
download=Downloaden
downloadDesktop=Download draw.io Desktop
downloadAs=Downloaden als
clickHereToSave=Klik hier om op te slaan.
draftDiscarded=Concept genegeerd
draftSaved=Concept opgeslagen
dragElementsHere=Sleep elementen hierheen
dragImagesHere=Sleep afbeeldingen of URL's hierheen
dragUrlsHere=Sleep URL's hierheen
draw.io=draw.io
drawing=Tekening{1}
drawingEmpty=Tekening is blanco
drawingTooLarge=Tekening is te groot
drawioForWork=Draw.io voor GSuite
dropbox=Dropbox
duplicate=Dupliceren
duplicateIt={1} dupliceren
divider=Scheiding
dx=Dx
dy=Dy
east=Rechts
edit=Bewerken
editData=Gegevens bewerken
editDiagram=Diagram bewerken
editGeometry=Geometrie bewerken
editImage=Afbeelding bewerken
editImageUrl=URL bewerken
editLink=Link bewerken
editShape=Vorm bewerken
editStyle=Stijl bewerken
editText=Tekst bewerken
editTooltip=Tooltip bewerken
glass=Glas
googleImages=Google Afbeeldingen
imageSearch=Afbeelding zoeken
eip=EIP
embed=Insluiten
embedImages=Afbeeldingen Insluiten
mainEmbedNotice=Dit op de pagina plakken
electrical=Elektrisch
ellipse=Ellips
embedNotice=Dit eenmalig aan het einde van de pagina plakken
enterGroup=Groep Invullen
enterName=Naam invullen
enterPropertyName=Eigenschapsnaam invullen
enterValue=Waarde invullen
entityRelation=Entiteitsrelatie
error=Fout
errorDeletingFile=Fout bij verwijderen bestand
errorLoadingFile=Fout bij laden bestand
errorRenamingFile=Fout bij hernoemen bestand.
errorRenamingFileNotFound=Fout bij hernoemen bestand. Bestand was niet gevonden.
errorRenamingFileForbidden=Fout bij hernoemen bestand. Onvoldoende toegangsrechten.
errorSavingDraft=Fout bij opslaan concept
errorSavingFile=Fout bij opslaan bestand
errorSavingFileUnknown=Fout bij het autoriseren met Google servers. Pagina herladen om nogmaals te proberen.
errorSavingFileForbidden=Fout bij opslaan bestand. Onvoldoende toegangsrechten.
errorSavingFileNameConflict=Kon diagram niet opslaan. Huidige pagina bevat al een bestand genaamd '{1}'.
errorSavingFileNotFound=Fout bij opslaan bestand. Bestand niet gevonden.
errorSavingFileReadOnlyMode=Kon diagram niet opslaan wanneer de modus alleen-lezen geactiveerd is.
errorSavingFileSessionTimeout=Uw sessie is verlopen. Graag <a target='_blank' href='{1}'>{2}</a> en ga weer naar dit tabblad om opnieuw te proberen op te slaan.
errorSendingFeedback=Fout bij versturen opmerking.
errorUpdatingPreview=Fout bij bijwerken voorbeeld.
exit=Afsluiten
exitGroup=Groep verlaten
expand=Uitklappen
export=Exporteren
exporting=Exporteren
exportAs=Exporteren als
exportOptionsDisabled=Exportopties uitgeschakeld
exportOptionsDisabledDetails=De eigenaar heeft opties voor het downloaden, afdrukken of kopiëren uitgeschakeld voor commentatoren en bekijkers van dit bestand.
extras=Extra's
facebook=Facebook
failedToSaveTryReconnect=Opslaan mislukt, opnieuw verbinden maken
featureRequest=Nieuwe functies aanvragen
feedback=Opmerkingen
feedbackSent=Opmerkingen verstuurd.
floorplans=Plattegronden
file=Bestand
fileChangedOverwrite=Bestand is gewijzigd. Wijzigingen overschrijven?
overwrite=Overschrijven
filename=Bestandsnaam
fileExists=Bestand bestaat al
fileNearlyFullSeeFaq=Bestand bijna vol, bekijk Veelgestelde vragen
fileNotFound=Bestand niet gevonden
repositoryNotFound=Opslaglocatie niet gevonden
fileNotFoundOrDenied=Bestand niet gevonden. Het bestaat niet of u heeft geen rechten om te lezen.
fileNotLoaded=Bestand niet geladen
fileNotSaved=Bestand niet opgeslagen
fileOpenLocation=Hoe wilt u dit/deze bestand(en) openen?
fileWillBeSavedInAppFolder={1} zal in de appfolder worden opgeslagen.
fill=Vullen
fillColor=Vulkleur
filterCards=Kaarten filteren
find=Zoeken
fit=Inpassen
fitContainer=Containergrootte aanpassen
fitIntoContainer=In Container passen
fitPage=Passend op pagina
fitPageWidth=Passend op paginabreedte
fitTo=Passen op
fitToSheetsAcross=blad(en) naast elkaar
fitToBy=bij
fitToSheetsDown=blad(en) onder elkaar
fitTwoPages=Twee pagina's
fitWindow=Passend in venster
flip=Spiegelen
flipH=Horizontaal spiegelen
flipV=Verticaal spiegelen
flowchart=Stroomschema
folder=Map
font=Lettertype
fontColor=Tekstkleur
fontFamily=Lettertypefamilie
fontSize=Tekstgrootte
forbidden=U bent niet geautoriseerd dit bestand te openen
format=Opmaken
formatPanel=Opmaakpaneel
formatted=Opgemaakt
formattedText=Opgemaakte tekst
formatPng=PNG
formatGif=GIF
formatJpg=JPEG
formatPdf=PDF
formatSql=SQL
formatSvg=SVG
formatHtmlEmbedded=HTML
formatSvgEmbedded=SVG (met XML)
formatVsdx=VSDX
formatVssx=VSSX
formatXmlPlain=XML (eenvoudig)
formatXml=XML
forum=Discussie-/Helpforums
fromTemplate=Van sjabloon
fromTemplateUrl=Van sjabloon-URL
fromText=Van tekst
fromUrl=Van URL
fromThisPage=Van deze pagina
fullscreen=Volledig scherm
gap=Opening
gcp=GCP
general=Algemeen
github=GitHub
gliffy=Gliffy
global=Globaal
googleDocs=Google Docs
googleDrive=Google Drive
googleGadget=Google Gadget
googlePlus=Google+
googleSites=Google Sites
gradient=Gradiënt
gradientColor=Kleur
grid=Raster
gridColor=Rasterkleur
gridSize=Rastergrootte
group=Groeperen
guides=Hulplijnen
hateApp=Ik haat draw.io
heading=Kop
height=Hoogte
help=Help
helpTranslate=Help ons deze applicatie te vertalen
hide=Verbergen
hideIt={1} verbergen
hidden=Verborgen
home=Home
horizontal=Horizontaal
horizontalFlow=Horizontale stroom
horizontalTree=Horizontale boom
howTranslate=Hoe goed is de vertaling naar uw taal?
html=HTML
htmlText=HTML-tekst
id=ID
iframe=iFrame
ignore=Negeren
image=Afbeelding
imageUrl=Afbeelding-URL
images=Afbeeldingen
imagePreviewError=Deze afbeelding kon niet worden geladen voor voorbeeldweergave. Controleer de URL.
imageTooBig=Afbeelding te groot
imgur=Imgur
import=Importeren
importFrom=Importeren van
includeCopyOfMyDiagram=Een kopie van mijn diagram toevoegen
increaseIndent=Inspringing vergroten
decreaseIndent=Inspringing verkleinen
insert=Invoegen
insertColumnBefore=Kolom links invoegen
insertColumnAfter=Kolom rechts invoegen
insertEllipse=Ellips invoegen
insertImage=Afbeelding invoegen
insertHorizontalRule=Horizontale lijn invoegen
insertLink=Link invoegen
insertPage=Pagina invoegen
insertRectangle=Rechthoek invoegen
insertRhombus=Ruit invoegen
insertRowBefore=Rij bovenaan invoegen
insertRowAfter=Rij onderaan invoegen
insertText=Tekst invoegen
inserting=Invoegen
invalidFilename=Een Diagramnaam mag niet de volgende tekens bevatten: \ / | : ; { } < > & + ? = "
invalidLicenseSeeThisPage=Uw licentie is ongeldig, bekijk deze <a target="_blank" href="https://support.draw.io/display/DFCS/Licensing+your+draw.io+plugin">pagina</a>.
invalidName=Ongeldige naam
invalidOrMissingFile=Ongeldig of ontbrekend bestand
invalidPublicUrl=Ongeldige publieke URL
isometric=Isometrisch
ios=iOS
italic=Cursief
kennedy=Kennedy
keyboardShortcuts=Sneltoetscombinaties
layers=Lagen
landscape=Landschap
language=Taal
leanMapping=Lean Mapping
lastChange=Laatste wijziging {1} geleden
lessThanAMinute=minder dan een minuut
licensingError=Licentiefout
licenseHasExpired=De licentie voor {1} is verlopen op {2}. Klik hier.
licenseWillExpire=De licentie voor {1} zal op {2} verlopen. Klik hier
lineJumps=Kruisende lijnen
linkAccountRequired=Als het diagram niet openbaar is, is een Google-account vereist om de link te bekijken.
linkText=Linktekst
list=Lijst
minute=minuut
minutes=minuten
hours=uur
days=dagen
months=maanden
years=jaren
restartForChangeRequired=Wijzigingen zullen na het herladen van de pagina zichtbaar zijn.
laneColor=Laankleur
lastModified=Laatst aangepast
layout=Pagina-opmaak
left=Links
leftAlign=Links Uitlijnen
leftToRight=Links naar rechts
libraryTooltip=Sleep en plaats de vormen hier of klik + om in te voegen. Dubbelklik om aan te passen.
lightbox=Lightbox
line=Lijn
lineend=Einde van de lijn
lineheight=Lijnhoogte
linestart=Begin van de Lijn
linewidth=Lijnbreedte
link=Link
links=Links
loading=Laden
lockUnlock=Vergrendelen/ontgrendelen
loggedOut=Uitgelogd
logIn=Inloggen
loveIt=Ik hou van {1}
lucidchart=Lucidchart
maps=Maps
mathematicalTypesetting=Wiskundige notatie
makeCopy=Een kopie maken
manual=Handleiding
middle=Midden
minimal=Minimaal
misc=Overige
mockups=Modellen
modificationDate=Aanpassingsdatum
modifiedBy=Aangepast door
more=Meer
moreResults=Meer resultaten
moreShapes=Meer vormen
move=Verplaatsen
moveToFolder=Naar map verplaatsen
moving=Verplaatsen
moveSelectionTo=Selectie naar {1} verplaatsen
name=Naam
navigation=Navigatie
network=Netwerk
networking=Netwerken
new=Nieuw
newLibrary=Nieuwe bibliotheek
nextPage=Volgende pagina
no=Nee
noAttachments=Geen bijlagen gevonden
noColor=Geen kleur
noFiles=Geen bestanden
noFileSelected=Geen bestand geselecteerd
noLibraries=Geen bibliotheken gevonden
noMoreResults=Geen verdere resultaten
none=Geen
noOtherViewers=Geen andere bekijkers
noPlugins=Geen plug-ins
noPreview=Geen voorbeeldweergave
noResponse=Geen antwoord van de server
noResultsFor=Geen resultaten voor '{1}'
noRevisions=Geen revisies
noSearchResults=Geen zoekresultaten gevonden
noPageContentOrNotSaved=Geen ankers op deze pagina gevonden of hij is nog niet opgeslagen.
normal=Normaal
north=Boven
notADiagramFile=Geen diagrambestand
notALibraryFile=Geen bibliotheekbestand
notAvailable=Niet beschikbaar
notAUtf8File=Geen UTF-8-bestand
notConnected=Niet verbonden
note=Opmerking
notUsingService=Gebruikt u {1} niet?
numberedList=Genummerde lijst
offline=Offline
ok=OK
oneDrive=OneDrive
online=Online
opacity=Ondoorzichtigheid
open=Openen
openArrow=Open Pijl
openExistingDiagram=Bestaand diagram openen
openFile=Bestand openen
openFrom=Openen van
openLibrary=Bibliotheek openen
openLibraryFrom=Bibliotheek openen van
openLink=Link openen
openInNewWindow=In nieuw venster openen
openInThisWindow=In dit venster openen
openIt={1} openen
openRecent=Recent geopend
openSupported=Ondersteunde formaten zijn bestanden opgeslagen vanuit deze software (,xml), .vsdx en .gliffy
options=Opties
organic=Organisch
orthogonal=Orthogonaal
otherViewer=andere bekijker
otherViewers=andere bekijkers
outline=Overzicht
oval=Ovaal
page=Pagina
pageContent=Pagina-inhoud
pageNotFound=Pagina niet gevonden
pageWithNumber=Pagina-{1}
pages=Pagina's
pageView=Paginaweergave
pageSetup=Pagina-instelling
pageScale=Paginaschaal
pan=Zoomen
panTooltip=Spatie+slepen om te zoomen
paperSize=Papiergrootte
pattern=Patroon
paste=Plakken
pasteHere=Hier plakken
pasteSize=Paste Size
pasteStyle=Stijl plakken
perimeter=Begrenzing
permissionAnyone=Iedereen kan bewerken
permissionAuthor=Alleen ik kan bewerken
pickFolder=Kies een map
pickLibraryDialogTitle=Bibliotheek selecteren
publicDiagramUrl=Openbare URL van het diagram
placeholders=Plaatshouder
plantUml=PlantUML
plugins=Plug-ins
pluginUrl=Plug-in URL
pluginWarning=De pagina heeft gevraagd de volgende plug-in(s) te laden:\n \n {1}\n \n Wilt u deze plug-in(s) nu laden?\n \n OPMERKING: sta plug-ins alleen toe om uitgevoerd te worden als u de veiligheidsrisico's volledig begrijpt.\n
plusTooltip=Klik om te verbinden en klonen (ctrl+klik om te klonen, shift+klik om te verbinden). Sleep om te verbinden (ctrl+slepen om te klonen).
portrait=Portret
position=Positie
posterPrint=Poster afdrukken
preferences=Voorkeuren
preview=Voorbeeldweergave
previousPage=Vorige pagina
print=Afdrukken
printAllPages=Alle pagina's afdrukken
procEng=Procestechnologie
project=Project
priority=Prioriteit
properties=Eigenschappen
publish=Publiceren
quickStart=Introductievideo
rack=Rek
radialTree=Radiale boom
readOnly=Alleen-lezen
reconnecting=Opnieuw verbinden
recentlyUpdated=Recent bijgewerkt
recentlyViewed=Recent bekeken
rectangle=Rechthoek
redirectToNewApp=Dit bestand is aangemaakt of aangepast in een nieuwere versie van deze app. U wordt nu doorgestuurd.
realtimeTimeout=Het lijkt alsof u enkele wijzigingen hebt aangebracht terwijl u offline was. Het spijt ons, maar deze wijzigingen kunnen niet worden opgeslagen.
redo=Opnieuw
refresh=Herladen
regularExpression=Reguliere expressie
relative=Relative
relativeUrlNotAllowed=Relatieve URL niet toegestaan
rememberMe=Onthoud mij
rememberThisSetting=Deze instelling onthouden
removeFormat=Opmaak wissen
removeFromGroup=Uit groep verwijderen
removeIt={1} verwijderen
removeWaypoint=Tussenpunt verwijderen
rename=Hernoemen
renamed=Hernoemd
renameIt={1} hernoemen
renaming=Hernoemen
replace=Vervangen
replaceIt={1} bestaat al. Wilt u deze vervangen?
replaceExistingDrawing=Bestaande tekening vervangen
required=vereist
reset=Lijst wissen
resetView=Weergave herstellen
resize=Grootte aanpassen
resizeLargeImages=Wilt u grote afbeeldingen verschalen om de app sneller te laten functioneren?
retina=HiDPI
responsive=Responsief
restore=Herstellen
restoring=Herstellen
retryingIn=Opnieuw proberen over {1} seconde(n)
retryingLoad=Laden mislukt. Opnieuw...
retryingLogin=Logintijd verlopen. Opnieuw...
reverse=Ongedaan maken
revision=Revisie
revisionHistory=Revisiegeschiedenis
rhombus=Ruit
right=Rechts
rightAlign=Rechts Uitlijnen
rightToLeft=Rechts naar links
rotate=Draaien
rotateTooltip=Klik en sleep om te draaien, klik om 90 graden te draaien
rotation=Rotatie
rounded=Afgerond
save=Opslaan
saveAndExit=Opslaan & afsluiten
saveAs=Opslaan als
saveAsXmlFile=Opslaan als XML-bestand?
saved=Opgeslagen
saveDiagramsTo=Diagrammen opslaan naar
saveLibrary403=Onvoldoende rechten om deze bibliotheek te bewerken
saveLibrary500=Er is een fout opgetreden bij het opslaan van de bibliotheek
saving=Opslaan
scratchpad=Pallet
scrollbars=Schuifbalken
search=Zoeken
searchShapes=Vormen zoeken
selectAll=Alles selecteren
selectionOnly=Alleen selectie
selectCard=Kaart selecteren
selectEdges=Randen selecteren
selectFile=Bestand selecteren
selectFolder=Map selecteren
selectFont=Lettertype selecteren
selectNone=Niets selecteren
selectTemplate=Sjabloon selecteren
selectVertices=Hoekpunten selecteren
sendMessage=Versturen
sendYourFeedbackToDrawIo=Stuur uw opmerkingen naar draw.io
serviceUnavailableOrBlocked=Dienst niet beschikbaar of geblokkeerd
sessionExpired=Uw sessie is verlopen. Ververs het browservenster.
sessionTimeoutOnSave=Uw sessie is verlopen en uw verbinding met Google Drive is verbroken. Druk op OK om in te loggen en op te slaan.
setAsDefaultStyle=Als Standaardstijl Instellen
shadow=Schaduw
shape=Vorm
shapes=Vormen
share=Delen
shareLink=Link voor gedeeld bewerken
sharp=Rechthoekig
show=Tonen
showStartScreen=Startscherm tonen
sidebarTooltip=Klik om uit te breiden. Sleep en plaats vormen in het diagram. Shift+klik om selectie te wijzigen. Alt+klik om in te voegen en te verbinden.
signs=Tekens
signOut=Afmelden
simple=Eenvoudig
simpleArrow=Eenvoudige pijl
size=Grootte
solid=Massief
sourceSpacing=Bronafstand
south=Onder
software=Software
space=Ruimte
spacing=Afstand
specialLink=Speciale Link
standard=Standaard
starting=Opstarten
straight=Recht
strokeColor=Lijnkleur
style=Stijl
subscript=Subscript
summary=Samenvatting
superscript=Superscript
support=Ondersteuning
sysml=SysML
tags=Labels
table=Tabel
tables=Tabellen
takeOver=Overnemen
targetSpacing=Doelafstand
template=Sjabloon
templates=Sjablonen
text=Tekst
textAlignment=Tekstuitlijning
textOpacity=Tekstopaciteit
theme=Thema
timeout=Time-out
title=Titel
to=tot
toBack=Naar achteren
toFront=Naar voren
tooltips=Tooltips
top=Boven
topAlign=Boven uitlijnen
topLeft=Linksboven
topRight=Rechtsboven
transparent=Transparant
transparentBackground=Transparante achtergrond
trello=Trello
tryAgain=Opnieuw proberen
tryOpeningViaThisPage=Probeer via deze pagina te openen.
turn=90° draaien
type=Type
twitter=Twitter
uml=UML
underline=Onderstrepen
undo=Ongedaan maken
ungroup=Degroeperen
unsavedChanges=Niet-opgeslagen wijzigingen
unsavedChangesClickHereToSave=Niet-opgeslagen wijzigingen. Klik hier om op te slaan.
untitled=Zonder titel
untitledDiagram=Diagram zonder titel
untitledLayer=Laag zonder titel
untitledLibrary=Bibliotheek zonder titel
unknownError=Onbekende fout
updateFile={1} bijwerken
updatingDocument=Document wordt bijgewerkt. Even wachten...
updatingPreview=Voorbeeld wordt bijgewerkt. Even wachten...
updatingSelection=Selectie wordt bijgewerkt. Even wachten...
upload=Uploaden
url=URL
useOffline=Use Offline
useRootFolder=Hoofdmap gebruiken?
userManual=Gebruikershandleiding
vertical=Verticaal
verticalFlow=Verticale stroom
verticalTree=Verticale boom
view=Bekijken
viewUrl=Link om te bekijken: {1}
voiceAssistant=Spraakassistent (beta)
warning=Waarschuwing
waypoints=Tussenpunten
west=Links
width=Breedte
wiki=Wiki
wordWrap=Tekstterugloop
writingDirection=Schrijfrichting
yes=Ja
yourEmailAddress=Uw e-mailadres
zoom=Zoomen
zoomIn=Inzoomen
zoomOut=Uitzoomen
basic=Basis
businessprocess=Bedrijfsprocessen
charts=Grafieken
engineering=Elektrisch
flowcharts=Stroomschema's
gmdl=Materiaalontwerp
mindmaps=Mindmaps
mockups=Modellen
networkdiagrams=Netwerkdiagrammen
nothingIsSelected=Niets geselecteerd
other=Overige
softwaredesign=Softwareontwerp
venndiagrams=Venn Diagrammen
webEmailOrOther=Web, e-mail of een ander internetadres
webLink=Weblink
wireframes=Draadmodellen
