# *DO NOT DIRECTLY EDIT THIS FILE, IT IS AUTOMATICALLY GENERATED AND IT IS BASED ON:*
# https://docs.google.com/spreadsheet/ccc?key=0AmQEO36liL4FdDJLWVNMaVV2UmRKSnpXU09MYkdGbEE
aboutDrawio=O aplikacji draw.io
accessDenied=Brak dostępu
action=Action
actualSize=Rozmiar rzeczywisty
add=Dodaj
addedFile=Dodano {1}
addImages=Dodaj obrazy
addImageUrl=Dodaj adres URL obrazu
addLayer=Dodaj warstwę
addProperty=Dodaj atrybut
address=Adres
addToExistingDrawing=Dodaj do istniejącego rysunku
addWaypoint=Dodaj punkt trasy
adjustTo=Dostosuj do
advanced=Zaawansowane
align=Wyrównaj
alignment=Wyrównywanie
allChangesLost=Wszystkie zmiany zostaną utracone!
allPages=Wszystkie strony
allProjects=Wszystkie projekty
allSpaces=Wszystkie obszary
allTags=Wszystkie znaczniki
anchor=Kotwica
android=Android
angle=Kąt
arc=Arc
areYouSure=Czy jesteś pewny?
ensureDataSaved=Przed zamknięciem upewnij się, czy dane zostały zapisane.  
allChangesSaved=Zapisano wszystkie zmiany 
allChangesSavedInDrive=Wszystkie zmiany zapisano na dysku Drive
allowPopups=Zezwalaj na wyskakiwanie okienek, aby zapobiec pojawianiu się tego okna.
allowRelativeUrl=Allow relative URL
alreadyConnected=Węzły zostały już połączone
apply=Zastosuj
archiMate21=ArchiMate 2.1
arrange=Rozmieść
arrow=Strzałka
arrows=Strzałki
asNew=Jako nowy
atlas=Nowoczesny
author=Autor
authorizationRequired=Wymagana autoryzacja
authorizeThisAppIn=Autoryzuj tę aplikację w {1}: 
authorize=Autoryzuj 
authorizing=Autoryzacja
automatic=Automatycznie
autosave=Automatyczny zapis
autosize=Automatycznie dopasowanie rozmiaru
attachments=Załączniki
aws=AWS
aws3d=AWS 3D
azure=Azure
background=Tło
backgroundColor=Kolor tła
backgroundImage=Zdjęcie w tle 
basic=Podstawowy 
blankDrawing=Pusty rysunek
blankDiagram=Pusty diagram
block=Blok
blockquote=Cytat
blog=Blog
bold=Pogrubienie
bootstrap=Bootstrap
border=Border
borderColor=Kolor ramki
borderWidth=Szerokość ramki
bottom=Dół
bottomAlign=Wyrównanie do dołu
bottomLeft=Lewy dół
bottomRight=Prawy dół
bpmn=BMPN
browser=Przeglądarka
bulletedList=Lista wypunktowana
business=Biznesowe
busy=Operacja w toku
cabinets=Skrzynka
cancel=Anuluj
center=Do środka
cannotLoad=Próba załadowania zakończona niepowodzeniem. Spróbuj później.
cannotLogin=Próba logowania zakończona niepowodzeniem. Spróbuj później.
cannotOpenFile=Nie można otworzyć pliku
change=Zmień
changeOrientation=Zmień orientację
changeUser=Zmień użytkownika
changesNotSaved=Zmiany nie zostały zapisanie
chatJoined={1} dołączył
chatLeft={1} opuścił
chatWindowTitle=Chat 
chooseAnOption=Wybierz opcję
chromeApp=Aplikacja Chrome
compressed=Skompresowany
commitMessage=commit Wiadomość
csv=CSV
dark=Dark
draftFound=Znaleziono wersję roboczą {1}. Załaduj ją do edytora lub odrzuć, by kontynuować.
dragAndDropNotSupported=Przeciągnij i upuść dla obrazów nie jest wspierane. Czy chcesz zamiast tego użyć importowania?
dropboxCharsNotAllowed=Następujące znaki są niedozwolone: \ / : ? * " |
check=Sprawdź
circle=Okrąg
cisco=Cisco
classic=Klasyczny
clearDefaultStyle=Wyczyść styl domyślny
clearWaypoints=Wyczyść punkty trasy
clipart=Clipart
close=Zamknij
collaborator=Współuczestnik
collaborators=Współuczestnicy
collapse=Zwiń
collapseExpand=Zwiń/Rozwiń
collapse-expand=Kliknij, aby zwinąć/rozwinąć\nkliknij prztrzymując klawisz Shift, aby przesunąć sąsiadujące \nkliknij przytrzymując klawisz Alt, aby zabezpieczyć rozmiar grupy
collapsible=Zwijalny 
comic=Komiksowy
comment=Komentarz
commentsNotes=Komentarze/uwagi
compress=Compress
connect=Połącz
connecting=Łączenie
connectWithDrive=Połącz z Dyskiem Google
connection=Połączenie
connectionArrows=Strzałki łączące
connectionPoints=Punkty połączenia
constrainProportions=Zachowaj proporcje
containsValidationErrors=Zawiera błędy potwierdzenia
copiedToClipboard=Skopiowano do schowka
copy=Kopiuj
copyConnect=Kopiuj przy połączeniu
copyOf=Kopia {1}
copyOfDrawing=Kopia rysunku
copySize=Copy Size
copyStyle=Kopiuj styl
create=Utwórz
createNewDiagram=Utwórz nowy diagram
createRevision=Utwórz wersję
createShape=Utwórz kształt
crop=Przytnij
curved=Zakrzywiony
custom=Dostosuj
current=Aktualny 
cut=Wytnij
dashed=Przerywana
decideLater=Zdecyduj później
default=Domyślny
delete=Usuń
deleteColumn=Usuń kolumnę
deleteLibrary401=Nie masz wystarczających uprawnień do usunięcia tej biblioteki
deleteLibrary404=Nie odnaleziono wybranej biblioteki
deleteLibrary500=Wystąpił błąd podczas usuwania biblioteki
deleteLibraryConfirm=Zamierzasz trwale usunąć tę bibliotekę. Czy jesteś pewien?
deleteRow=Usuń wiersz
description=Opis
device=Urządzenie
diagram=Diagram
diagramContent=Zawartość diagramu
diagramLocked=Diagram został zablokowany w celu zabezpieczenia go przed dalszą utratą danych.
diagramLockedBySince=The diagram is locked by {1} since {2} ago
diagramName=Nazwa diagramu
diagramIsPublic=Diagram jest publiczny
diagramIsNotPublic=Diagram nie jest publiczny
diamond=Diament
diamondThin=Diament (cienki)
didYouKnow=Czy wiesz...
direction=Kierunek
discard=Odrzuć
discardChangesAndReconnect=Odrzuć zmiany i połącz ponownie
googleDriveMissingClickHere=Brak Dysku Google? Kliknij tutaj!
discardChanges=Odrzuć zmiany i połącz ponownie
disconnected=Rozłączony
distribute=Rozprowadź
done=Gotowe
dotted=Kropkowany
doubleClickOrientation=Kliknij dwukrotnie, aby zmienić położenie
doubleClickTooltip=Kliknij dwukrotnie, aby wstawić tekst
doubleClickChangeProperty=Kliknij dwukrotnie, aby zmienić nazwę atrybutu
download=Pobierz
downloadDesktop=Download draw.io Desktop
downloadAs=Pobierz jako
clickHereToSave=Kliknij tutaj, aby zapisać
draftDiscarded=Wersja robocza została odrzucona
draftSaved=Wersja robocza została zapisana
dragElementsHere=Przeciągnij elementy tutaj
dragImagesHere=Przeciągnij obrazy lub hiperłącza tutaj 
dragUrlsHere=Przeciągnij hiperłącza tutaj 
draw.io=draw.io
drawing=Rysunek{1}
drawingEmpty=Rysunek jest pusty
drawingTooLarge=Rysunek jest zbyt duży
drawioForWork=Draw.io dla GSuite
dropbox=Dropbox
duplicate=Duplikuj
duplicateIt=Duplikuj {1}
divider=Znak podziału
dx=Dx
dy=Dy
east=Wschód
edit=Edytuj
editData=Edytuj dane
editDiagram=Edytuj diagram
editGeometry=Edytuj kształt bryły
editImage=Edytuj obraz 
editImageUrl=Edytuj hiperłącze obrazu 
editLink=Edytuj hiperłącze
editShape=Edytuj kształt
editStyle=Edytuj styl
editText=Edytuj tekst
editTooltip=Edytuj dymek
glass=Szkło
googleImages=Obrazy Google
imageSearch=Wyszukiwanie obrazów
eip=EIP
embed=Osadź
embedImages=Obrazy osadzone
mainEmbedNotice=Wklej na stronie
electrical=Elektryczne
ellipse=Ellipse
embedNotice=Wklej na końcu strony
enterGroup=Wprowadź grupę
enterName=Wprowadź nazwę 
enterPropertyName=Wprowadź nazwę atrybutu 
enterValue=Wprowadź wartość
entityRelation=Związek encji
error=Błąd
errorDeletingFile=Błąd podczas usuwania pliku
errorLoadingFile=Błąd podczas ładowania pliku
errorRenamingFile=Błąd podczas zmiany nazwy pliku.
errorRenamingFileNotFound=Błąd podczas zmiany nazwy pliku. Plik nie został odnaleziony.
errorRenamingFileForbidden=Błąd podczas zmiany nazwy pliku. Brak wystarczających praw dostępu.
errorSavingDraft=Błąd podczas zapisywania wersji roboczej
errorSavingFile=Błąd przy zapisywaniu pliku
errorSavingFileUnknown=Błąd podczas autoryzacji z serwerami Google. Proszę odświeżyć stronę, aby dokonać kolejnej próby.
errorSavingFileForbidden=Błąd podczas zapisywania pliku. Brak wystarczających praw dostępu.
errorSavingFileNameConflict=Nie można zapisać diagramu. Aktualna strona zawiera już plik '{1}'
errorSavingFileNotFound=Błąd podczas zapisywania pliku. Plik nie został odnaleziony.
errorSavingFileReadOnlyMode=Could not save diagram while read-only mode is active.
errorSavingFileSessionTimeout=Twoja sesja wygasła. <a target='_blank' href='{1}'>{2}</a> i wróć do tej karty, by spróbować zapisać ponownie.
errorSendingFeedback=Błąd podczas przesyłania opinii.
errorUpdatingPreview=Błąd podczas aktualizowania podglądu.
exit=Wyjdź
exitGroup=Wyjdź z grupy
expand=Rozwiń
export=Eksportuj
exporting=Eksportowanie
exportAs=Eksportuj jako
exportOptionsDisabled=Opcja eksporu została zablokowana
exportOptionsDisabledDetails=Właściciel zablokował możliwość pobierania, drukowania i kopiowania dla przeglądających i komentujących.
extras=Dodatki
facebook=Facebook
failedToSaveTryReconnect=Błąd zapisu, próbuję połączyć ponownie
featureRequest=Zgłoszenie dotyczące funkcjonalności
feedback=Opinia
feedbackSent=Przesyłanie opinii powiodło się.
floorplans=Rzuty pomieszczeń
file=Plik
fileChangedOverwrite=Plik został zmieniony. Nadpisać zmiany?
overwrite=Nadpisz
filename=Nazwa pliku
fileExists=Plik już istnieje
fileNearlyFullSeeFaq=Plik prawie pełen, sprawdź FAQ
fileNotFound=Plik nie został odnaleziony
repositoryNotFound=Repozytorium nie zostało odnalezione
fileNotFoundOrDenied=Plik nie został odnaleziony. Plik nie istnieje lub nie posiadasz prawa dostępu do jego odczytu.
fileNotLoaded=Plik niezaładowany
fileNotSaved=Plik niezapisany
fileOpenLocation=W jaki sposób chcesz otworzyć ten/te plik(i)?
fileWillBeSavedInAppFolder={1} zostanie zapisany w folderze aplikacji.
fill=Wypełnij
fillColor=Kolor wypełnienia
filterCards=Filter Cards
find=Znajdź
fit=Dopasuj
fitContainer=Zmień wymiary kontenera 
fitIntoContainer=Dopasuj do kontenera
fitPage=Dopasuj stronę  
fitPageWidth=Dopasuj szerokość strony
fitTo=Dopasuj do
fitToSheetsAcross=arkusz(e) wzdłuż
fitToBy=na
fitToSheetsDown=arkusz(e) w dół
fitTwoPages=Dwie strony
fitWindow=Dopasuj do okna
flip=Odbij
flipH=Odbij poziomo
flipV=Odbij pionowo
flowchart=Schemat blokowy
folder=Folder
font=Czcionka
fontColor=Kolor czcionki
fontFamily=Rodzaj czcionki
fontSize=Wielkość czcionki
forbidden=Nie masz uprawnień do otwarcia tego pliku
format=Formatuj
formatPanel=Panel formatowania
formatted=Sformatowany
formattedText=Tekst sformatowany
formatPng=PNG
formatGif=GIF
formatJpg=JPEG
formatPdf=PDF
formatSql=SQL
formatSvg=SVG
formatHtmlEmbedded=HTML
formatSvgEmbedded=SVG (z XML)
formatVsdx=VSDX
formatVssx=VSSX
formatXmlPlain=XML (normalny) 
formatXml=XML
forum=Dyskusja/Forum wsparcia
fromTemplate=Z szablonu
fromTemplateUrl=Z adresu URL szablonu 
fromText=Z tekstu
fromUrl=Z hiperłącza
fromThisPage=Z tej strony
fullscreen=Pełnoekranowy
gap=Gap
gcp=GCP
general=Ogólny
github=GitHub
gliffy=Gliffy
global=Globalny
googleDocs=Google Docs
googleDrive=Google Drive
googleGadget=Google Gadget
googlePlus=Google+
googleSites=Google Sites
gradient=Cieniowanie
gradientColor=Kolor
grid=Siatka
gridColor=Kolor siatki
gridSize=Rozmiar siatki
group=Grupuj
guides=Przewodniki
hateApp=Nienawidzę draw.io
heading=Nagłówek
height=Wysokość
help=Pomoc
helpTranslate=Pomóż nam przetłumaczyć tę aplikację
hide=Ukryj
hideIt=Ukryj {1}
hidden=Ukryte
home=Początek
horizontal=Poziomo
horizontalFlow=Przepływ poziomy
horizontalTree=Drzewo poziome
howTranslate=Jak dobre jest tłumaczenie w Twoim języku?
html=HTML
htmlText=Tekst w HTML
id=ID
iframe=IFrame
ignore=Ignoruj
image=Obraz
imageUrl=Hiperłącze obrazu
images=Obrazy
imagePreviewError=Podgląd tego obrazu nie mógł być załadowany. Sprawdź hiperłącze.
imageTooBig=Obraz zbyt duży
imgur=Imgur
import=Importuj
importFrom=Importuj z
includeCopyOfMyDiagram=Dołącz kopię mojego diagramu
increaseIndent=Zwiększ wcięcie 
decreaseIndent=Zmniejsz wcięcie 
insert=Wstaw
insertColumnBefore=Wstaw kolumnę z lewej
insertColumnAfter=Wstaw kolumnę z prawej
insertEllipse=Wstaw elipsę 
insertImage=Wstaw obraz 
insertHorizontalRule=Wstaw poziomą linię  
insertLink=Wstaw hiperłącze
insertPage=Wstaw stronę
insertRectangle=Wstaw prostokąt
insertRhombus=Insert Rhombus
insertRowBefore=Wstaw wiersz u góry
insertRowAfter=Wstaw wiersz u dołu
insertText=Wstaw tekst
inserting=Wstawianie
invalidFilename=Nazwy diagramów nie mogą zawierać następujących znaków: \ / | : ; { } < > & + ? = "
invalidLicenseSeeThisPage=Twoja licencja jest nieważna, sprawdź <a target="_blank" href="https://support.draw.io/display/DFCS/Licensing+your+draw.io+plugin">page</a>.
invalidName=Nieprawidłowa nazwa
invalidOrMissingFile=Nieprawidłowy lub brakujący plik
invalidPublicUrl=Nieprawidłowe publiczne hiperłącze
isometric=Izometryczny
ios=iOS
italic=Kursywa
kennedy=Kennedy
keyboardShortcuts=Skróty klawiszowe
layers=Warstwy
landscape=Poziomy
language=Język
leanMapping=Mapowanie Lean
lastChange=Ostatnia zmiana {1} temu
lessThanAMinute=poniżej minuty 
licensingError=Błąd licencji
licenseHasExpired=Licencja dla {1} wygasła {2}. Kliknij tutaj.
licenseWillExpire=Licencja dla {1} wygaśnie {2}. Kliknij tutaj.
lineJumps=Line jumps
linkAccountRequired=Jeśli diagram nie jest publiczny, wymagane jest konto Google, by zobaczyć link.
linkText=Hiperłącze tekstu
list=Lista
minute=minutę 
minutes=minut
hours=godzin
days=dni
months=miesięcy
years=lat
restartForChangeRequired=Zmiany zostaną wprowadzone po odświeżeniu strony.
laneColor=Kolor toru
lastModified=Ostatnio zmodyfikowano
layout=Układ
left=Do lewej
leftAlign=Wyrównaj do lewej
leftToRight=Od lewej do prawej 
libraryTooltip=Przeciągnij kształty lub kliknij +, aby wstawić. Kliknij podwójnie, aby edytować
lightbox=Lightbox
line=Linia
lineend=Koniec linii
lineheight=Wysokość linii
linestart=Początek linii
linewidth=Szerokość linii
link=Hiperłącze
links=Hiperłącza
loading=Ładuję
lockUnlock=Zablokuj/odblokuj
loggedOut=Wylogowany
logIn=Zaloguj
loveIt=Kocham {1}
lucidchart=Lucidchart
maps=Maps
mathematicalTypesetting=Matematyczny zestaw znaków 
makeCopy=Zrób kopię 
manual=Ręczny
middle=Środek
minimal=Minimal
misc=Różne
mockups=Modele
modificationDate=Data zmiany
modifiedBy=Zmienione przez
more=Więcej 
moreResults=Więcej wyników
moreShapes=Więcej kształtów
move=Przenieś
moveToFolder=Przenieś do folderu
moving=Przenoszenie
moveSelectionTo=Przenieś zaznaczone do {1}
name=Nazwa
navigation=Nawigacja
network=Network
networking=Sieci komputerowe
new=Nowy
newLibrary=Nowa biblioteka
nextPage=Następna strona
no=Nie
noAttachments=Nie znaleziono załączników
noColor=Brak koloru
noFiles=Brak plików
noFileSelected=Nie wybrano żadnego pliku
noLibraries=Nie znaleziono bibliotek
noMoreResults=Nie ma więcej wyników
none=Żaden
noOtherViewers=Brak innych użytkowników
noPlugins=Brak wtyczek
noPreview=Brak podglądu
noResponse=Brak odpowiedzi z serwera
noResultsFor=Brak wyników dla '{1}'
noRevisions=Brak zmian
noSearchResults=Brak wyników wyszukiwania
noPageContentOrNotSaved=Na tej stronie nie znaleziono kotwic lub nie zostały jeszcze zapisane
normal=Normalny
north=Północ
notADiagramFile=To nie jest plik diagramu
notALibraryFile=To nie jest plik biblioteki
notAvailable=Niedostępny
notAUtf8File=To nie jest plik z kodowaniem UTF-8
notConnected=Niepołączony
note=Notka 
notUsingService=Nie używasz {1}?
numberedList=Lista numerowana
offline=Offline
ok=OK
oneDrive=OneDrive
online=Online
opacity=Przezroczystość
open=Otwórz
openArrow=Otwarta strzałka 
openExistingDiagram=Otwórz istniejący diagram
openFile=Otwórz plik
openFrom=Otwórz z 
openLibrary=Otwórz bibliotekę
openLibraryFrom=Otwórz bibliotekę z
openLink=Otwórz hiperłącze
openInNewWindow=Otwórz w nowym oknie
openInThisWindow=Otwórz w tym oknie
openIt=Otwórz {1}
openRecent=Otwórz ostatnie
openSupported=Wspierane są pliki utworzone w tym programie (.xml), .vsdx oraz .gliffy
options=Opcje
organic=Organiczny
orthogonal=Prostopadły
otherViewer=inny użytkownik
otherViewers=inni użytkownicy
outline=Obramowanie
oval=Owalny
page=Strona
pageContent=Zawartość strony
pageNotFound=Strona nieodnaleziona
pageWithNumber=Strona-{1}
pages=Strony
pageView=Widok strony
pageSetup=Ustawienia strony
pageScale=Skalowanie strony
pan=Panorama
panTooltip=Spacja+przeciągnij do panoramy
paperSize=Rozmiar papieru
pattern=Wzór
paste=Wklej
pasteHere=Wklej tutaj
pasteSize=Paste Size
pasteStyle=Wklej styl
perimeter=Granica
permissionAnyone=Każdy może edytować
permissionAuthor=Tylko ja mogę edytować
pickFolder=Wybierz folder
pickLibraryDialogTitle=Wybierz bibliotekę
publicDiagramUrl=Publiczny adres URL diagramu
placeholders=Symbol zastępczy
plantUml=PlantUML
plugins=Wtyczki
pluginUrl=Adres URL wtyczki
pluginWarning=Strona wymaga załadowania następujących wtyczek(s):\n \n {1}\n \n Czy chcesz załadować te wtyczki teraz?\n \n UWAGA : Wtyczki należy uruchamiać wyłącznie przy zupełnym zrozumieniu, jaki mają one wpływ na bezpieczeństwo danych.\n
plusTooltip=Kliknij, aby połączyć i sklonować (ctrl+kliknij, by skopiować, shift+kliknij, by połączyć). Przeciągnij, by połączyć (ctrl+przeciągnij, by sklonować).
portrait=Pionowy
position=Pozycja
posterPrint=Wydruk plakatu
preferences=Preferencje
preview=Podgląd
previousPage=Poprzednia strona
print=Drukuj
printAllPages=Wydrukuj wszystkie strony
procEng=Technologia
project=Projekt
priority=Priorytet
properties=Właściwości
publish=Publikuj
quickStart=Szybki start (wideo)
rack=Szafa serwerowa
radialTree=Drzewo radialne
readOnly=Tylko do odczytu
reconnecting=Łączę ponownie
recentlyUpdated=Ostatnio zakutalizowane
recentlyViewed=Ostatnio przeglądane
rectangle=Rectangle
redirectToNewApp=Ten plik został utworzony lub zmodyfikowany w nowszej wersji programu. Teraz nastąpi przekierowanie.
realtimeTimeout=Wygląda na to, że dokonał-eś/aś kilku zmian w trybie offline. Przepraszamy, ale te zmiany nie mogą zostać zapisane.
redo=Powtórz
refresh=Odśwież
regularExpression=Wyrażenie regularne
relative=Relative
relativeUrlNotAllowed=Relative URL not allowed
rememberMe=Zapamiętaj mnie 
rememberThisSetting=Zapamiętaj te ustawienia 
removeFormat=Wyczyść formatowanie
removeFromGroup=Usuń z grupy
removeIt=Usuń {1}
removeWaypoint=Usuń punkt trasy
rename=Zmień nazwę 
renamed=Nazwa zmieniona 
renameIt=Zmień nazwę {1}
renaming=Zmienianie nazwy
replace=Zamień
replaceIt={1} już istnieje. Chcesz go zastąpić?
replaceExistingDrawing=Zastąp istniejący rysunek
required=wymagany
reset=Resetuj
resetView=Resetuj widok
resize=Zmień rozmiar
resizeLargeImages=Do you want to resize large images to make the application run faster?
retina=Retina
responsive=Responsywny
restore=Przywróć 
restoring=Przywracanie
retryingIn=Ponawiam w ciągu {1} sekund/y
retryingLoad=Błąd ładowania. Ponawiam...
retryingLogin=Upłynął czas logowania. Ponawiam...
reverse=Odwróć
revision=Zmiana
revisionHistory=Historia zmian
rhombus=Rhombus
right=Do prawej
rightAlign=Wyrównaj do prawej
rightToLeft=Od prawej do lewej
rotate=Obróć
rotateTooltip=Kliknij i przeciągnij, aby obrócić; kliknij, aby przekręcić o 90 stopni
rotation=Obrót
rounded=Zaokrąglony
save=Zapisz
saveAndExit=Zapisz i wyjdź
saveAs=Zapisz jako
saveAsXmlFile=Zapisać jako plik XML?
saved=Zapisany
saveDiagramsTo=Zapisz diagramy w
saveLibrary403=Niewystarczające uprawnienia do edycji tej biblioteki
saveLibrary500=Wystąpił błąd podczas zapisywania biblioteki
saving=Zapisuję
scratchpad=Brudnopis
scrollbars=Paski przewijania
search=Szukaj
searchShapes=Szukaj kształtów
selectAll=Zaznacz wszystko
selectionOnly=Tylko wybrane
selectCard=Select Card
selectEdges=Zaznacz brzegi
selectFile=Wybierz plik
selectFolder=Wybierz folder
selectFont=Wybierz czcionkę
selectNone=Odznacz wszystko
selectTemplate=Select Template
selectVertices=Zaznacz wierzchołki
sendMessage=Wyślij
sendYourFeedbackToDrawIo=Wyślij opinię do draw.io
serviceUnavailableOrBlocked=Usługa zablokowana lub niedostępna
sessionExpired=Sesja wygasła. Proszę odświeżyć okno przeglądarki.
sessionTimeoutOnSave=Twoja sesja wygasła, a Dysk Google został rozłączony. Wciśnij OK, aby się zalogować i zapisać.
setAsDefaultStyle=Ustaw jako styl domyślny
shadow=Cień
shape=Kształt
shapes=Kształty
share=Udostępnij
shareLink=Hiperłącze do umożliwienia edycji innym użytkownikom
sharp=Ostry
show=Pokaż
showStartScreen=Pokaż ekran startowy
sidebarTooltip=Kliknij, aby rozwinąć. Przeciągnij i upuść kształty na diagram. Shift+kliknij, aby zmienić zaznaczenie. Alt+kliknij, aby wstawić i połączyć.
signs=Znaki
signOut=Wyloguj
simple=Proste
simpleArrow=Prosta strzałka
size=Rozmiar
solid=Ciągła
sourceSpacing=Rozmieszczenie źródła
south=Południe
software=Oprogramowanie
space=Obszar
spacing=Rozmieszczenie
specialLink=Łącze specjalne 
standard=Standardowe
starting=Uruchamianie
straight=Prosty
strokeColor=Kolor linii
style=Styl
subscript=Indeks dolny
summary=Podsumowanie
superscript=Indeks górny
support=Wsparcie
sysml=SysML
tags=Znaczniki
table=Tabela
tables=Tables
takeOver=Take Over
targetSpacing=Rozmieszczenie celu
template=Szablon
templates=Szablony
text=Tekst
textAlignment=Wyrównanie tekstu
textOpacity=Przezroczystość tekstu
theme=Motyw
timeout=Czas upłynął
title=Tytuł
to=do
toBack=Do tyłu
toFront=Do przodu
tooltips=Dymki podpowiedzi
top=Góra
topAlign=Wyrównaj do góry
topLeft=Lewy górny
topRight=Prawy górny
transparent=Przezroczysty
transparentBackground=Przezroczyste tło
trello=Trello
tryAgain=Spróbuj ponownie
tryOpeningViaThisPage=Spróbuj otworzyć poprzez tę stronę.
turn=Obróć o 90°
type=Rodzaj
twitter=Twitter
uml=UML
underline=Podkreślenie
undo=Cofnij
ungroup=Rozgrupuj
unsavedChanges=Niezapisane zmiany
unsavedChangesClickHereToSave=Niezapisane zmiany. Kliknij tutaj, aby zapisać.
untitled=Bez tytułu
untitledDiagram=Diagram bez tytułu
untitledLayer=Warstwa bez nazwy
untitledLibrary=Biblioteka bez tytułu
unknownError=Nieznany błąd
updateFile=Zaktualizuj {1}
updatingDocument=Aktualizowanie dokumentu. Proszę czekać...
updatingPreview=Aktualizowanie podglądu. Proszę czekać...
updatingSelection=Aktualizowanie wyboru. Proszę czekać...
upload=Załaduj
url=URL
useOffline=Use Offline
useRootFolder=Use root folder?
userManual=Podręcznik użytkownika
vertical=Pionowy 
verticalFlow=Pionowy przepływ
verticalTree=Pionowe drzewo
view=Widok
viewUrl=Hiperłącze do widoku: {1}
voiceAssistant=Asystent głosowy (beta)
warning=Ostrzeżenie
waypoints=Punkty trasy
west=Zachód
width=Szerokość
wiki=Wiki
wordWrap=Zawijanie słów
writingDirection=Kierunek tekstu
yes=Tak
yourEmailAddress=Twój adres e-mail
zoom=Zoom
zoomIn=Przybliż
zoomOut=Oddal
basic=Podstawowy
businessprocess=Procesy biznesowe
charts=Wykresy
engineering=Inżynieria
flowcharts=Schematy blokowe
gmdl=Projektowanie materiałowe
mindmaps=Mapy myśli
mockups=Modele
networkdiagrams=Diagramy sieciowe
nothingIsSelected=Nic nie wybrano
other=Inne
softwaredesign=Projekt oprogramowania
venndiagrams=Diagramy Venna
webEmailOrOther=Strona, email lub dowolny inny adres internetowy
webLink=Hiperłącze strony
wireframes=Projekty ramowe 
